geoid,geoid20,year,denom_enrolled,frpl_count,frpl_pct,freemeals_count,reducedmeals_count
1400000US06037101110,6037101110,2023,1186,969,81.699997,889,80
1400000US06037101220,6037101220,2023,201,181,90.050003,174,7
1400000US06037101300,6037101300,2023,492,363,73.779999,311,52
1400000US06037102107,6037102107,2023,777,651,83.779999,563,88
1400000US06037103101,6037103101,2023,744,586,78.760002,544,42
1400000US06037103102,6037103102,2023,548,451,82.300003,421,30
1400000US06037103202,6037103202,2023,133,108,81.199997,99,9
1400000US06037103402,6037103402,2023,345,202,58.549999,190,12
1400000US06037104103,6037104103,2023,618,542,87.699997,472,70
1400000US06037104105,6037104105,2023,654,582,88.989998,517,65
1400000US06037104108,6037104108,2023,958,919,95.93,887,32
1400000US06037104124,6037104124,2023,1079,965,89.43,838,127
1400000US06037104204,6037104204,2023,360,348,96.669998,340,8
1400000US06037104310,6037104310,2023,2809,2743,97.650002,2430,313
1400000US06037104321,6037104321,2023,871,706,81.059998,681,25
1400000US06037104401,6037104401,2023,527,502,95.260002,489,13
1400000US06037104500,6037104500,2023,620,577,93.059998,543,34
1400000US06037104821,6037104821,2023,800,687,85.879997,604,83
1400000US06037104822,6037104822,2023,899,839,93.330002,796,43
1400000US06037106020,6037106020,2023,185,95,51.349998,95,0
1400000US06037106112,6037106112,2023,526,462,87.830002,430,32
1400000US06037106113,6037106113,2023,339,225,66.370003,200,25
1400000US06037106114,6037106114,2023,375,312,83.199997,282,30
1400000US06037106403,6037106403,2023,2035,1834,90.120003,1710,124
1400000US06037106405,6037106405,2023,2184,1926,88.190002,1820,106
1400000US06037106510,6037106510,2023,121,121,100,121,0
1400000US06037106520,6037106520,2023,1571,1463,93.129997,1357,106
1400000US06037106603,6037106603,2023,400,188,47,154,34
1400000US06037106604,6037106604,2023,339,321,94.690002,306,15
1400000US06037106641,6037106641,2023,1384,746,53.900002,614,132
1400000US06037106642,6037106642,2023,429,143,33.330002,129,14
1400000US06037106646,6037106646,2023,2594,1839,70.889999,1576,263
1400000US06037106648,6037106648,2023,307,273,88.93,253,20
1400000US06037107020,6037107020,2023,519,481,92.68,457,24
1400000US06037108104,6037108104,2023,580,116,20,110,6
1400000US06037108202,6037108202,2023,1324,245,18.5,229,16
1400000US06037109200,6037109200,2023,266,200,75.190002,184,16
1400000US06037109300,6037109300,2023,534,388,72.660004,333,55
1400000US06037109500,6037109500,2023,1783,1671,93.720001,1595,76
1400000US06037109601,6037109601,2023,613,419,68.349998,373,46
1400000US06037109700,6037109700,2023,995,654,65.730003,568,86
1400000US06037109800,6037109800,2023,767,425,55.41,328,97
1400000US06037111100,6037111100,2023,393,284,72.260002,251,33
1400000US06037111202,6037111202,2023,336,236,70.239998,226,10
1400000US06037111204,6037111204,2023,2496,1077,43.150002,910,167
1400000US06037111206,6037111206,2023,393,204,51.91,179,25
1400000US06037111302,6037111302,2023,375,273,72.800003,252,21
1400000US06037111303,6037111303,2023,1871,1325,70.82,1152,173
1400000US06037111304,6037111304,2023,5799,2808,48.419998,2262,546
1400000US06037111401,6037111401,2023,451,308,68.290001,284,24
1400000US06037113101,6037113101,2023,510,331,64.900002,299,32
1400000US06037113212,6037113212,2023,382,210,54.970001,192,18
1400000US06037113232,6037113232,2023,311,274,88.099998,265,9
1400000US06037113303,6037113303,2023,476,291,61.130001,252,39
1400000US06037113322,6037113322,2023,400,96,24,94,2
1400000US06037113323,6037113323,2023,1073,729,67.940002,685,44
1400000US06037113324,6037113324,2023,1727,1204,69.720001,1099,105
1400000US06037113428,6037113428,2023,615,576,93.660004,552,24
1400000US06037115101,6037115101,2023,2078,1114,53.610001,991,123
1400000US06037115103,6037115103,2023,892,680,76.230003,612,68
1400000US06037115202,6037115202,2023,447,315,70.470001,284,31
1400000US06037115301,6037115301,2023,519,168,32.369999,157,11
1400000US06037115302,6037115302,2023,379,355,93.669998,351,4
1400000US06037115401,6037115401,2023,690,651,94.349998,632,19
1400000US06037115403,6037115403,2023,251,205,81.669998,182,23
1400000US06037115404,6037115404,2023,268,74,27.610001,72,2
1400000US06037117101,6037117101,2023,2506,2400,95.769997,2280,120
1400000US06037117102,6037117102,2023,380,340,89.470001,324,16
1400000US06037117202,6037117202,2023,2215,2044,92.279999,1970,74
1400000US06037117302,6037117302,2023,409,378,92.419998,359,19
1400000US06037117303,6037117303,2023,285,115,40.349998,109,6
1400000US06037117407,6037117407,2023,496,488,98.389999,478,10
1400000US06037117510,6037117510,2023,510,487,95.489998,422,65
1400000US06037117520,6037117520,2023,520,512,98.459999,500,12
1400000US06037117530,6037117530,2023,700,677,96.709999,662,15
1400000US06037119003,6037119003,2023,448,421,93.970001,410,11
1400000US06037119004,6037119004,2023,435,380,87.360001,345,35
1400000US06037119201,6037119201,2023,1528,1405,91.949997,1330,75
1400000US06037119342,6037119342,2023,517,480,92.839996,461,19
1400000US06037119802,6037119802,2023,587,512,87.220001,484,28
1400000US06037119900,6037119900,2023,799,739,92.489998,667,72
1400000US06037120010,6037120010,2023,1149,1128,98.169998,1110,18
1400000US06037120020,6037120020,2023,538,525,97.580002,517,8
1400000US06037120030,6037120030,2023,1589,1511,95.089996,1460,51
1400000US06037120107,6037120107,2023,429,417,97.199997,408,9
1400000US06037120108,6037120108,2023,806,784,97.269997,768,16
1400000US06037120300,6037120300,2023,266,251,94.360001,244,7
1400000US06037120400,6037120400,2023,383,348,90.860001,337,11
1400000US06037121010,6037121010,2023,3348,3144,93.910004,2966,178
1400000US06037121020,6037121020,2023,404,377,93.32,350,27
1400000US06037121102,6037121102,2023,245,188,76.730003,165,23
1400000US06037121210,6037121210,2023,337,281,83.379997,249,32
1400000US06037121222,6037121222,2023,2497,2323,93.029999,2103,220
1400000US06037121600,6037121600,2023,35,28,80,26,2
1400000US06037121801,6037121801,2023,316,306,96.839996,300,6
1400000US06037121900,6037121900,2023,342,320,93.57,309,11
1400000US06037122000,6037122000,2023,495,463,93.540001,443,20
1400000US06037122122,6037122122,2023,496,466,93.949997,436,30
1400000US06037122200,6037122200,2023,200,184,92,174,10
1400000US06037122420,6037122420,2023,417,390,93.529999,375,15
1400000US06037123010,6037123010,2023,1530,1430,93.459999,1355,75
1400000US06037123301,6037123301,2023,382,372,97.379997,362,10
1400000US06037123303,6037123303,2023,585,556,95.040001,530,26
1400000US06037123420,6037123420,2023,1284,1193,92.910004,1165,28
1400000US06037123510,6037123510,2023,672,626,93.150002,614,12
1400000US06037123601,6037123601,2023,1804,1606,89.019997,1526,80
1400000US06037123602,6037123602,2023,577,544,94.279999,528,16
1400000US06037123700,6037123700,2023,628,525,83.599998,477,48
1400000US06037123901,6037123901,2023,1626,1497,92.07,1432,65
1400000US06037124102,6037124102,2023,612,547,89.379997,528,19
1400000US06037124201,6037124201,2023,583,555,95.199997,536,19
1400000US06037124300,6037124300,2023,262,247,94.269997,240,7
1400000US06037124600,6037124600,2023,1329,596,44.849998,561,35
1400000US06037124700,6037124700,2023,369,136,36.860001,131,5
1400000US06037124902,6037124902,2023,318,253,79.559998,237,16
1400000US06037125101,6037125101,2023,2761,1804,65.339996,1674,130
1400000US06037125102,6037125102,2023,686,171,24.93,161,10
1400000US06037125310,6037125310,2023,989,653,66.029999,618,35
1400000US06037125322,6037125322,2023,300,269,89.669998,266,3
1400000US06037125600,6037125600,2023,458,304,66.379997,284,20
1400000US06037127210,6037127210,2023,2421,2090,86.330002,2041,49
1400000US06037127400,6037127400,2023,452,425,94.029999,413,12
1400000US06037127603,6037127603,2023,571,550,96.32,521,29
1400000US06037127803,6037127803,2023,228,156,68.419998,148,8
1400000US06037127805,6037127805,2023,419,398,94.989998,385,13
1400000US06037127806,6037127806,2023,2324,1959,84.290001,1864,95
1400000US06037127910,6037127910,2023,859,653,76.019997,608,45
1400000US06037127920,6037127920,2023,611,571,93.449997,552,19
1400000US06037128102,6037128102,2023,733,651,88.809998,620,31
1400000US06037128302,6037128302,2023,616,587,95.290001,574,13
1400000US06037128602,6037128602,2023,381,200,52.490002,182,18
1400000US06037128802,6037128802,2023,1919,1312,68.370003,1229,83
1400000US06037128910,6037128910,2023,139,69,49.639999,68,1
1400000US06037131022,6037131022,2023,353,334,94.620003,327,7
1400000US06037131023,6037131023,2023,367,324,88.279999,313,11
1400000US06037131100,6037131100,2023,402,294,73.129997,270,24
1400000US06037131200,6037131200,2023,345,252,73.040001,225,27
1400000US06037131300,6037131300,2023,346,332,95.949997,329,3
1400000US06037131600,6037131600,2023,3050,2152,70.559998,2008,144
1400000US06037131701,6037131701,2023,51,32,62.75,30,2
1400000US06037131801,6037131801,2023,980,819,83.57,762,57
1400000US06037131900,6037131900,2023,267,240,89.889999,222,18
1400000US06037132001,6037132001,2023,331,285,86.099998,258,27
1400000US06037132002,6037132002,2023,5986,4949,82.68,4468,481
1400000US06037132301,6037132301,2023,281,255,90.75,239,16
1400000US06037132501,6037132501,2023,3,2,66.669998,2,0
1400000US06037132700,6037132700,2023,1916,1676,87.470001,1606,70
1400000US06037133000,6037133000,2023,629,384,61.049999,362,22
1400000US06037133101,6037133101,2023,375,338,90.129997,329,9
1400000US06037133102,6037133102,2023,1781,933,52.389999,768,165
1400000US06037134001,6037134001,2023,627,600,95.690002,585,15
1400000US06037134002,6037134002,2023,457,264,57.77,243,21
1400000US06037134101,6037134101,2023,330,304,92.120003,300,4
1400000US06037134103,6037134103,2023,414,388,93.720001,380,8
1400000US06037134104,6037134104,2023,449,390,86.860001,350,40
1400000US06037134302,6037134302,2023,367,278,75.75,258,20
1400000US06037134303,6037134303,2023,484,467,96.489998,454,13
1400000US06037134304,6037134304,2023,959,876,91.349998,827,49
1400000US06037134421,6037134421,2023,547,128,23.4,122,6
1400000US06037134422,6037134422,2023,196,140,71.43,124,16
1400000US06037134423,6037134423,2023,360,132,36.669998,131,1
1400000US06037134520,6037134520,2023,1430,1314,91.889999,1264,50
1400000US06037134522,6037134522,2023,668,598,89.519997,583,15
1400000US06037134720,6037134720,2023,1484,1302,87.739998,1248,54
1400000US06037134801,6037134801,2023,333,308,92.489998,296,12
1400000US06037135102,6037135102,2023,290,171,58.970001,150,21
1400000US06037135202,6037135202,2023,745,132,17.719999,116,16
1400000US06037135204,6037135204,2023,819,210,25.639999,207,3
1400000US06037137000,6037137000,2023,3497,1090,31.17,1023,67
1400000US06037137104,6037137104,2023,610,488,80,473,15
1400000US06037137203,6037137203,2023,516,400,77.519997,390,10
1400000US06037137301,6037137301,2023,567,178,31.389999,175,3
1400000US06037137302,6037137302,2023,1887,693,36.720001,613,80
1400000US06037137401,6037137401,2023,646,159,24.610001,157,2
1400000US06037137402,6037137402,2023,399,82,20.549999,75,7
1400000US06037137501,6037137501,2023,2723,1415,51.959999,1230,185
1400000US06037139001,6037139001,2023,299,74,24.75,67,7
1400000US06037139200,6037139200,2023,276,185,67.029999,170,15
1400000US06037139301,6037139301,2023,541,427,78.93,399,28
1400000US06037139402,6037139402,2023,2673,1049,39.240002,946,103
1400000US06037139502,6037139502,2023,375,226,60.27,216,10
1400000US06037139600,6037139600,2023,510,167,32.75,149,18
1400000US06037139701,6037139701,2023,490,43,8.7799997,42,1
1400000US06037141101,6037141101,2023,595,155,26.049999,144,11
1400000US06037141304,6037141304,2023,478,172,35.98,167,5
1400000US06037141400,6037141400,2023,495,73,14.75,68,5
1400000US06037143200,6037143200,2023,729,415,56.93,377,38
1400000US06037143302,6037143302,2023,1463,760,51.950001,675,85
1400000US06037143700,6037143700,2023,128,47,36.720001,47,0
1400000US06037143801,6037143801,2023,832,91,10.94,87,4
1400000US06037181000,6037181000,2023,362,325,89.779999,286,39
1400000US06037181400,6037181400,2023,724,247,34.119999,219,28
1400000US06037181500,6037181500,2023,759,297,39.130001,271,26
1400000US06037181600,6037181600,2023,2047,985,48.119999,807,178
1400000US06037183101,6037183101,2023,1126,967,85.879997,909,58
1400000US06037183104,6037183104,2023,219,168,76.709999,153,15
1400000US06037183220,6037183220,2023,189,157,83.07,150,7
1400000US06037183401,6037183401,2023,271,218,80.440002,196,22
1400000US06037183402,6037183402,2023,220,183,83.18,175,8
1400000US06037183510,6037183510,2023,1417,1252,88.360001,1166,86
1400000US06037183520,6037183520,2023,224,209,93.300003,202,7
1400000US06037183702,6037183702,2023,170,148,87.059998,137,11
1400000US06037183810,6037183810,2023,350,273,78,264,9
1400000US06037185101,6037185101,2023,452,347,76.769997,326,21
1400000US06037185102,6037185102,2023,343,253,73.760002,241,12
1400000US06037185204,6037185204,2023,417,54,12.95,44,10
1400000US06037185310,6037185310,2023,975,905,92.82,861,44
1400000US06037186100,6037186100,2023,439,171,38.950001,133,38
1400000US06037186401,6037186401,2023,1558,1276,81.900002,1182,94
1400000US06037186404,6037186404,2023,242,213,88.019997,203,10
1400000US06037187101,6037187101,2023,310,184,59.349998,173,11
1400000US06037187102,6037187102,2023,1141,714,62.580002,631,83
1400000US06037187300,6037187300,2023,283,222,78.449997,186,36
1400000US06037188201,6037188201,2023,415,48,11.57,47,1
1400000US06037188300,6037188300,2023,201,130,64.68,116,14
1400000US06037189201,6037189201,2023,387,332,85.790001,313,19
1400000US06037189501,6037189501,2023,155,121,78.059998,112,9
1400000US06037189905,6037189905,2023,350,223,63.709999,212,11
1400000US06037190102,6037190102,2023,1086,994,91.529999,964,30
1400000US06037190510,6037190510,2023,398,380,95.480003,369,11
1400000US06037190901,6037190901,2023,1257,1202,95.620003,1150,52
1400000US06037190902,6037190902,2023,835,784,93.889999,760,24
1400000US06037191120,6037191120,2023,303,290,95.709999,284,6
1400000US06037191204,6037191204,2023,260,252,96.919998,248,4
1400000US06037191301,6037191301,2023,71,60,84.510002,58,2
1400000US06037191410,6037191410,2023,309,302,97.730003,293,9
1400000US06037191720,6037191720,2023,733,707,96.449997,659,48
1400000US06037191810,6037191810,2023,247,228,92.309998,222,6
1400000US06037191901,6037191901,2023,446,411,92.150002,397,14
1400000US06037192001,6037192001,2023,440,181,41.139999,141,40
1400000US06037192002,6037192002,2023,1652,1345,81.419998,1269,76
1400000US06037192410,6037192410,2023,166,145,87.349998,137,8
1400000US06037192520,6037192520,2023,250,228,91.199997,223,5
1400000US06037192620,6037192620,2023,482,460,95.440002,445,15
1400000US06037192700,6037192700,2023,256,245,95.699997,229,16
1400000US06037194300,6037194300,2023,411,69,16.790001,65,4
1400000US06037195201,6037195201,2023,2293,1466,63.93,1320,146
1400000US06037195300,6037195300,2023,1722,1249,72.529999,1163,86
1400000US06037195400,6037195400,2023,330,113,34.240002,112,1
1400000US06037195500,6037195500,2023,142,127,89.440002,115,12
1400000US06037195710,6037195710,2023,722,654,90.580002,646,8
1400000US06037197200,6037197200,2023,206,164,79.610001,155,9
1400000US06037197300,6037197300,2023,372,199,53.490002,185,14
1400000US06037197410,6037197410,2023,101,56,55.450001,55,1
1400000US06037197420,6037197420,2023,773,704,91.07,618,86
1400000US06037199001,6037199001,2023,187,25,13.37,25,0
1400000US06037199002,6037199002,2023,243,227,93.419998,221,6
1400000US06037199120,6037199120,2023,337,266,78.93,240,26
1400000US06037199201,6037199201,2023,288,244,84.720001,233,11
1400000US06037199202,6037199202,2023,1167,1114,95.459999,1059,55
1400000US06037199300,6037199300,2023,524,455,86.830002,432,23
1400000US06037199400,6037199400,2023,94,90,95.739998,89,1
1400000US06037199700,6037199700,2023,972,912,93.830002,847,65
1400000US06037199801,6037199801,2023,307,288,93.809998,280,8
1400000US06037199802,6037199802,2023,444,414,93.239998,401,13
1400000US06037201120,6037201120,2023,172,150,87.209999,137,13
1400000US06037201200,6037201200,2023,254,237,93.309998,229,8
1400000US06037201301,6037201301,2023,276,262,94.93,253,9
1400000US06037201302,6037201302,2023,38,31,81.580002,29,2
1400000US06037201401,6037201401,2023,1421,1284,90.360001,1209,75
1400000US06037201402,6037201402,2023,1690,1527,90.360001,1452,75
1400000US06037201501,6037201501,2023,175,165,94.290001,164,1
1400000US06037201602,6037201602,2023,270,249,92.220001,231,18
1400000US06037201700,6037201700,2023,541,109,20.15,109,0
1400000US06037203100,6037203100,2023,360,351,97.5,343,8
1400000US06037203200,6037203200,2023,513,484,94.349998,471,13
1400000US06037203300,6037203300,2023,1688,1505,89.160004,1407,98
1400000US06037203500,6037203500,2023,173,168,97.110001,162,6
1400000US06037203601,6037203601,2023,513,498,97.080002,485,13
1400000US06037203800,6037203800,2023,446,424,95.07,417,7
1400000US06037204110,6037204110,2023,470,410,87.230003,361,49
1400000US06037204300,6037204300,2023,2377,2291,96.379997,2226,65
1400000US06037204410,6037204410,2023,206,191,92.720001,187,4
1400000US06037204420,6037204420,2023,593,571,96.290001,552,19
1400000US06037204700,6037204700,2023,2185,2056,94.099998,1929,127
1400000US06037204810,6037204810,2023,1163,1100,94.580002,1069,31
1400000US06037204820,6037204820,2023,590,558,94.580002,515,43
1400000US06037204910,6037204910,2023,1027,985,95.910004,957,28
1400000US06037205110,6037205110,2023,893,864,96.75,819,45
1400000US06037205120,6037205120,2023,77,73,94.809998,72,1
1400000US06037206010,6037206010,2023,253,176,69.57,164,12
1400000US06037206050,6037206050,2023,278,228,82.010002,203,25
1400000US06037206051,6037206051,2023,318,282,88.68,259,23
1400000US06037206054,6037206054,2023,1227,1178,96.010002,1135,43
1400000US06037207101,6037207101,2023,1153,804,69.730003,761,43
1400000US06037207103,6037207103,2023,578,490,84.779999,470,20
1400000US06037207400,6037207400,2023,270,200,74.07,194,6
1400000US06037207502,6037207502,2023,459,239,52.07,239,0
1400000US06037207712,6037207712,2023,326,237,72.699997,220,17
1400000US06037208001,6037208001,2023,2523,2315,91.760002,2234,81
1400000US06037208002,6037208002,2023,404,386,95.540001,356,30
1400000US06037208302,6037208302,2023,1341,1312,97.839996,1274,38
1400000US06037208401,6037208401,2023,792,779,98.360001,771,8
1400000US06037208501,6037208501,2023,797,478,59.970001,424,54
1400000US06037208610,6037208610,2023,412,386,93.690002,366,20
1400000US06037208710,6037208710,2023,57,54,94.739998,53,1
1400000US06037208720,6037208720,2023,636,592,93.080002,526,66
1400000US06037208801,6037208801,2023,365,359,98.360001,357,2
1400000US06037208802,6037208802,2023,699,658,94.129997,627,31
1400000US06037208902,6037208902,2023,1160,1151,99.220001,1149,2
1400000US06037209103,6037209103,2023,527,493,93.550003,480,13
1400000US06037209104,6037209104,2023,396,395,99.75,395,0
1400000US06037209106,6037209106,2023,851,847,99.529999,842,5
1400000US06037209202,6037209202,2023,1135,1121,98.769997,1109,12
1400000US06037209520,6037209520,2023,625,559,89.440002,512,47
1400000US06037209820,6037209820,2023,480,314,65.419998,311,3
1400000US06037210010,6037210010,2023,448,443,98.879997,437,6
1400000US06037211000,6037211000,2023,1373,1128,82.160004,1081,47
1400000US06037211121,6037211121,2023,946,891,94.190002,874,17
1400000US06037211122,6037211122,2023,2075,1943,93.639999,1872,71
1400000US06037211123,6037211123,2023,903,882,97.669998,861,21
1400000US06037211124,6037211124,2023,657,594,90.410004,594,0
1400000US06037211202,6037211202,2023,470,458,97.449997,448,10
1400000US06037211410,6037211410,2023,456,416,91.230003,396,20
1400000US06037211420,6037211420,2023,340,296,87.059998,284,12
1400000US06037212202,6037212202,2023,548,537,97.989998,529,8
1400000US06037212204,6037212204,2023,727,673,92.57,604,69
1400000US06037212303,6037212303,2023,317,227,71.610001,218,9
1400000US06037212304,6037212304,2023,3569,3423,95.910004,3344,79
1400000US06037212610,6037212610,2023,630,574,91.110001,556,18
1400000US06037212800,6037212800,2023,2063,1502,72.809998,1437,65
1400000US06037213201,6037213201,2023,518,476,91.889999,460,16
1400000US06037213202,6037213202,2023,417,408,97.839996,399,9
1400000US06037213310,6037213310,2023,91,89,97.800003,87,2
1400000US06037213320,6037213320,2023,900,860,95.559998,838,22
1400000US06037213402,6037213402,2023,546,533,97.620003,520,13
1400000US06037214100,6037214100,2023,623,150,24.08,147,3
1400000US06037214501,6037214501,2023,491,161,32.790001,158,3
1400000US06037216201,6037216201,2023,125,103,82.400002,94,9
1400000US06037216301,6037216301,2023,301,203,67.440002,188,15
1400000US06037216700,6037216700,2023,1579,803,50.849998,696,107
1400000US06037217101,6037217101,2023,269,253,94.050003,243,10
1400000US06037218110,6037218110,2023,1706,1294,75.849998,1242,52
1400000US06037218210,6037218210,2023,360,346,96.110001,335,11
1400000US06037218300,6037218300,2023,329,291,88.449997,262,29
1400000US06037218800,6037218800,2023,373,352,94.370003,346,6
1400000US06037218900,6037218900,2023,729,628,86.150002,583,45
1400000US06037219010,6037219010,2023,396,350,88.379997,340,10
1400000US06037219300,6037219300,2023,508,459,90.349998,434,25
1400000US06037219700,6037219700,2023,789,727,92.139999,713,14
1400000US06037219800,6037219800,2023,619,582,94.019997,546,36
1400000US06037219902,6037219902,2023,536,479,89.370003,461,18
1400000US06037220000,6037220000,2023,200,187,93.5,184,3
1400000US06037220100,6037220100,2023,727,549,75.519997,515,34
1400000US06037221120,6037221120,2023,542,542,100,531,11
1400000US06037221304,6037221304,2023,303,294,97.029999,287,7
1400000US06037221401,6037221401,2023,925,881,95.239998,843,38
1400000US06037221602,6037221602,2023,1791,1725,96.309998,1700,25
1400000US06037221810,6037221810,2023,344,329,95.639999,320,9
1400000US06037221900,6037221900,2023,273,264,96.699997,261,3
1400000US06037222002,6037222002,2023,385,355,92.209999,346,9
1400000US06037222500,6037222500,2023,1716,1605,93.529999,1557,48
1400000US06037222600,6037222600,2023,706,640,90.650002,614,26
1400000US06037224010,6037224010,2023,11,11,100,11,0
1400000US06037224020,6037224020,2023,1608,1533,95.339996,1453,80
1400000US06037224320,6037224320,2023,432,398,92.129997,375,23
1400000US06037224410,6037224410,2023,1727,1520,88.010002,1468,52
1400000US06037224420,6037224420,2023,735,606,82.449997,549,57
1400000US06037224600,6037224600,2023,1030,1002,97.279999,980,22
1400000US06037224702,6037224702,2023,890,791,88.879997,735,56
1400000US06037226001,6037226001,2023,2623,2557,97.480003,2516,41
1400000US06037226002,6037226002,2023,807,738,91.449997,722,16
1400000US06037226702,6037226702,2023,1061,1036,97.639999,1006,30
1400000US06037227020,6037227020,2023,1069,1062,99.349998,1039,23
1400000US06037228100,6037228100,2023,1564,1527,97.629997,1457,70
1400000US06037228210,6037228210,2023,1497,1468,98.059998,1437,31
1400000US06037228310,6037228310,2023,1056,1024,96.970001,1011,13
1400000US06037228320,6037228320,2023,471,463,98.300003,457,6
1400000US06037228410,6037228410,2023,688,673,97.82,626,47
1400000US06037228420,6037228420,2023,1216,971,79.849998,971,0
1400000US06037228500,6037228500,2023,605,597,98.68,572,25
1400000US06037228600,6037228600,2023,1104,1087,98.459999,1072,15
1400000US06037228710,6037228710,2023,1473,1391,94.43,1357,34
1400000US06037228720,6037228720,2023,638,627,98.279999,615,12
1400000US06037228800,6037228800,2023,155,154,99.349998,152,2
1400000US06037229200,6037229200,2023,528,517,97.919998,511,6
1400000US06037229300,6037229300,2023,493,486,98.580002,459,27
1400000US06037229410,6037229410,2023,2725,2680,98.349998,2613,67
1400000US06037229420,6037229420,2023,1317,1297,98.480003,1278,19
1400000US06037231100,6037231100,2023,1676,1629,97.199997,1564,65
1400000US06037231220,6037231220,2023,1107,943,85.190002,870,73
1400000US06037231302,6037231302,2023,313,306,97.760002,300,6
1400000US06037231400,6037231400,2023,139,87,62.59,87,0
1400000US06037231500,6037231500,2023,362,342,94.480003,317,25
1400000US06037231603,6037231603,2023,967,944,97.620003,920,24
1400000US06037231710,6037231710,2023,479,471,98.330002,463,8
1400000US06037231720,6037231720,2023,361,244,67.589996,236,8
1400000US06037231800,6037231800,2023,530,524,98.870003,519,5
1400000US06037232110,6037232110,2023,1025,1008,98.339996,998,10
1400000US06037232200,6037232200,2023,1175,1111,94.550003,1053,58
1400000US06037232300,6037232300,2023,237,232,97.889999,212,20
1400000US06037232401,6037232401,2023,742,707,95.279999,693,14
1400000US06037232500,6037232500,2023,522,496,95.019997,483,13
1400000US06037234001,6037234001,2023,629,552,87.760002,525,27
1400000US06037234002,6037234002,2023,394,358,90.860001,336,22
1400000US06037234301,6037234301,2023,548,530,96.720001,519,11
1400000US06037234501,6037234501,2023,786,753,95.800003,735,18
1400000US06037234502,6037234502,2023,440,427,97.050003,395,32
1400000US06037234600,6037234600,2023,2014,1968,97.720001,1791,177
1400000US06037234700,6037234700,2023,205,191,93.169998,181,10
1400000US06037234901,6037234901,2023,427,413,96.720001,407,6
1400000US06037234902,6037234902,2023,291,270,92.779999,255,15
1400000US06037235201,6037235201,2023,980,927,94.589996,880,47
1400000US06037236203,6037236203,2023,660,636,96.360001,590,46
1400000US06037236204,6037236204,2023,515,503,97.669998,497,6
1400000US06037236400,6037236400,2023,120,118,98.330002,118,0
1400000US06037237101,6037237101,2023,2452,2393,97.589996,2359,34
1400000US06037237102,6037237102,2023,549,539,98.18,532,7
1400000US06037237300,6037237300,2023,598,575,96.150002,566,9
1400000US06037237500,6037237500,2023,449,443,98.660004,438,5
1400000US06037237600,6037237600,2023,516,504,97.669998,498,6
1400000US06037237800,6037237800,2023,411,402,97.809998,390,12
1400000US06037237900,6037237900,2023,336,305,90.769997,296,9
1400000US06037238000,6037238000,2023,610,597,97.870003,592,5
1400000US06037238100,6037238100,2023,240,233,97.080002,233,0
1400000US06037238200,6037238200,2023,670,647,96.57,612,35
1400000US06037238320,6037238320,2023,1128,1068,94.68,984,84
1400000US06037238400,6037238400,2023,288,283,98.260002,278,5
1400000US06037239201,6037239201,2023,947,640,67.580002,637,3
1400000US06037239320,6037239320,2023,858,845,98.480003,831,14
1400000US06037239330,6037239330,2023,698,682,97.709999,668,14
1400000US06037239502,6037239502,2023,3120,3066,98.269997,3021,45
1400000US06037239601,6037239601,2023,755,727,96.290001,723,4
1400000US06037239802,6037239802,2023,843,817,96.919998,802,15
1400000US06037240010,6037240010,2023,1125,1104,98.129997,1074,30
1400000US06037240020,6037240020,2023,405,387,95.559998,371,16
1400000US06037240200,6037240200,2023,635,624,98.269997,617,7
1400000US06037240301,6037240301,2023,556,543,97.660004,538,5
1400000US06037240302,6037240302,2023,114,109,95.610001,106,3
1400000US06037240401,6037240401,2023,955,933,97.699997,911,22
1400000US06037240500,6037240500,2023,1407,1384,98.370003,1310,74
1400000US06037240600,6037240600,2023,781,769,98.459999,761,8
1400000US06037240700,6037240700,2023,462,451,97.620003,441,10
1400000US06037240902,6037240902,2023,1974,1882,95.339996,1817,65
1400000US06037241001,6037241001,2023,786,769,97.839996,735,34
1400000US06037241110,6037241110,2023,982,965,98.269997,943,22
1400000US06037241120,6037241120,2023,443,443,100,436,7
1400000US06037241202,6037241202,2023,497,483,97.18,476,7
1400000US06037241400,6037241400,2023,457,452,98.910004,446,6
1400000US06037242000,6037242000,2023,255,254,99.610001,249,5
1400000US06037242100,6037242100,2023,767,758,98.830002,747,11
1400000US06037242201,6037242201,2023,628,614,97.769997,598,16
1400000US06037242202,6037242202,2023,747,728,97.459999,708,20
1400000US06037242300,6037242300,2023,544,537,98.709999,532,5
1400000US06037242600,6037242600,2023,335,330,98.510002,327,3
1400000US06037242700,6037242700,2023,1076,1060,98.510002,1048,12
1400000US06037243001,6037243001,2023,497,482,96.980003,460,22
1400000US06037243002,6037243002,2023,301,297,98.669998,292,5
1400000US06037243100,6037243100,2023,358,351,98.040001,348,3
1400000US06037262200,6037262200,2023,829,130,15.68,120,10
1400000US06037262303,6037262303,2023,443,38,8.5799999,38,0
1400000US06037262604,6037262604,2023,306,42,13.73,42,0
1400000US06037262704,6037262704,2023,2876,766,26.629999,705,61
1400000US06037262706,6037262706,2023,418,42,10.05,39,3
1400000US06037262802,6037262802,2023,2101,463,22.040001,448,15
1400000US06037264305,6037264305,2023,249,206,82.730003,201,5
1400000US06037265100,6037265100,2023,532,44,8.2700005,43,1
1400000US06037265601,6037265601,2023,912,334,36.619999,306,28
1400000US06037267202,6037267202,2023,613,78,12.72,74,4
1400000US06037267300,6037267300,2023,175,143,81.709999,134,9
1400000US06037267404,6037267404,2023,1311,946,72.160004,856,90
1400000US06037267406,6037267406,2023,192,157,81.769997,144,13
1400000US06037267600,6037267600,2023,976,157,16.09,148,9
1400000US06037269000,6037269000,2023,479,134,27.969999,124,10
1400000US06037269100,6037269100,2023,319,92,28.84,87,5
1400000US06037269300,6037269300,2023,427,45,10.54,44,1
1400000US06037269700,6037269700,2023,2559,1968,76.910004,1813,155
1400000US06037269907,6037269907,2023,243,182,74.900002,170,12
1400000US06037271200,6037271200,2023,517,257,49.709999,226,31
1400000US06037271300,6037271300,2023,824,534,64.809998,506,28
1400000US06037271400,6037271400,2023,217,81,37.330002,77,4
1400000US06037271500,6037271500,2023,513,50,9.75,47,3
1400000US06037271702,6037271702,2023,416,103,24.76,100,3
1400000US06037271703,6037271703,2023,1244,819,65.839996,763,56
1400000US06037271801,6037271801,2023,226,185,81.860001,179,6
1400000US06037272100,6037272100,2023,1191,661,55.5,623,38
1400000US06037272302,6037272302,2023,11,7,63.639999,6,1
1400000US06037273200,6037273200,2023,909,458,50.389999,425,33
1400000US06037273403,6037273403,2023,327,255,77.980003,242,13
1400000US06037273800,6037273800,2023,2518,1537,61.040001,1408,129
1400000US06037274202,6037274202,2023,233,199,85.410004,193,6
1400000US06037275200,6037275200,2023,492,477,96.949997,428,49
1400000US06037275311,6037275311,2023,1336,552,41.32,533,19
1400000US06037275400,6037275400,2023,330,138,41.82,123,15
1400000US06037275500,6037275500,2023,817,529,64.75,493,36
1400000US06037275603,6037275603,2023,241,77,31.950001,70,7
1400000US06037275604,6037275604,2023,403,61,15.14,61,0
1400000US06037276000,6037276000,2023,175,127,72.57,119,8
1400000US06037276400,6037276400,2023,252,69,27.379999,68,1
1400000US06037276605,6037276605,2023,137,90,65.690002,85,5
1400000US06037276607,6037276607,2023,194,140,72.160004,124,16
1400000US06037276608,6037276608,2023,1053,707,67.139999,650,57
1400000US06037277000,6037277000,2023,1606,715,44.52,655,60
1400000US06037277100,6037277100,2023,397,51,12.85,50,1
1400000US06037291120,6037291120,2023,514,477,92.800003,460,17
1400000US06037291210,6037291210,2023,436,411,94.269997,402,9
1400000US06037291220,6037291220,2023,349,324,92.839996,296,28
1400000US06037291300,6037291300,2023,781,665,85.150002,647,18
1400000US06037293204,6037293204,2023,417,365,87.529999,352,13
1400000US06037293302,6037293302,2023,2458,2015,81.980003,1842,173
1400000US06037293304,6037293304,2023,409,385,94.129997,376,9
1400000US06037294110,6037294110,2023,3260,2970,91.099998,2778,192
1400000US06037294200,6037294200,2023,1308,1233,94.269997,1179,54
1400000US06037294302,6037294302,2023,448,282,62.950001,215,67
1400000US06037294410,6037294410,2023,269,262,97.400002,259,3
1400000US06037294510,6037294510,2023,606,565,93.230003,533,32
1400000US06037294520,6037294520,2023,330,308,93.330002,295,13
1400000US06037294610,6037294610,2023,1160,1049,90.43,1004,45
1400000US06037294620,6037294620,2023,487,473,97.129997,458,15
1400000US06037294830,6037294830,2023,628,604,96.18,590,14
1400000US06037294900,6037294900,2023,486,472,97.120003,459,13
1400000US06037295103,6037295103,2023,718,376,52.369999,332,44
1400000US06037296220,6037296220,2023,906,603,66.559998,509,94
1400000US06037296300,6037296300,2023,544,309,56.799999,271,38
1400000US06037296401,6037296401,2023,289,206,71.279999,189,17
1400000US06037296500,6037296500,2023,591,552,93.400002,538,14
1400000US06037296600,6037296600,2023,321,298,92.830002,290,8
1400000US06037296901,6037296901,2023,3947,2868,72.660004,2640,228
1400000US06037297120,6037297120,2023,370,337,91.080002,322,15
1400000US06037297202,6037297202,2023,381,324,85.040001,297,27
1400000US06037297400,6037297400,2023,439,219,49.889999,191,28
1400000US06037297501,6037297501,2023,298,98,32.889999,89,9
1400000US06037297601,6037297601,2023,57,49,85.959999,47,2
1400000US06037297602,6037297602,2023,315,197,62.540001,165,32
1400000US06037300200,6037300200,2023,2504,487,19.450001,425,62
1400000US06037300301,6037300301,2023,2402,879,36.59,754,125
1400000US06037300400,6037300400,2023,477,128,26.83,109,19
1400000US06037300501,6037300501,2023,2838,663,23.360001,583,80
1400000US06037300602,6037300602,2023,573,147,25.65,131,16
1400000US06037300800,6037300800,2023,606,176,29.040001,161,15
1400000US06037300902,6037300902,2023,476,165,34.66,154,11
1400000US06037301000,6037301000,2023,1104,649,58.790001,601,48
1400000US06037301206,6037301206,2023,3433,1708,49.75,1499,209
1400000US06037301400,6037301400,2023,869,491,56.5,444,47
1400000US06037301502,6037301502,2023,722,509,70.5,464,45
1400000US06037301602,6037301602,2023,594,111,18.690001,102,9
1400000US06037301801,6037301801,2023,442,310,70.139999,287,23
1400000US06037301902,6037301902,2023,937,573,61.150002,524,49
1400000US06037302002,6037302002,2023,110,58,52.73,54,4
1400000US06037302004,6037302004,2023,444,330,74.32,302,28
1400000US06037302104,6037302104,2023,1960,1201,61.279999,1060,141
1400000US06037302302,6037302302,2023,843,415,49.23,345,70
1400000US06037302504,6037302504,2023,2122,1547,72.900002,1392,155
1400000US06037302505,6037302505,2023,456,311,68.199997,268,43
1400000US06037310201,6037310201,2023,545,172,31.559999,160,12
1400000US06037310300,6037310300,2023,2231,679,30.43,648,31
1400000US06037310601,6037310601,2023,390,197,50.509998,188,9
1400000US06037310602,6037310602,2023,2418,812,33.580002,800,12
1400000US06037310703,6037310703,2023,739,318,43.029999,312,6
1400000US06037310705,6037310705,2023,26,17,65.379997,17,0
1400000US06037310800,6037310800,2023,2655,715,26.93,670,45
1400000US06037310900,6037310900,2023,556,125,22.48,119,6
1400000US06037311000,6037311000,2023,937,289,30.84,262,27
1400000US06037311100,6037311100,2023,849,265,31.209999,235,30
1400000US06037311200,6037311200,2023,282,99,35.110001,98,1
1400000US06037311500,6037311500,2023,1060,177,16.700001,157,20
1400000US06037311700,6037311700,2023,950,280,29.469999,251,29
1400000US06037311802,6037311802,2023,432,165,38.189999,148,17
1400000US06037320101,6037320101,2023,435,388,89.199997,372,16
1400000US06037320102,6037320102,2023,1557,1444,92.739998,1372,72
1400000US06037320201,6037320201,2023,1230,1161,94.389999,1091,70
1400000US06037320202,6037320202,2023,395,367,92.910004,351,16
1400000US06037320300,6037320300,2023,1499,1423,94.93,1351,72
1400000US06037400205,6037400205,2023,18,18,100,18,0
1400000US06037400208,6037400208,2023,546,75,13.74,70,5
1400000US06037400304,6037400304,2023,925,405,43.779999,382,23
1400000US06037400402,6037400402,2023,2192,926,42.240002,646,280
1400000US06037400403,6037400403,2023,22,22,100,22,0
1400000US06037400404,6037400404,2023,540,139,25.74,93,46
1400000US06037400501,6037400501,2023,725,231,31.860001,154,77
1400000US06037400602,6037400602,2023,532,412,77.440002,339,73
1400000US06037400605,6037400605,2023,347,277,79.830002,242,35
1400000US06037400801,6037400801,2023,1808,976,53.98,743,233
1400000US06037401001,6037401001,2023,567,212,37.389999,138,74
1400000US06037401202,6037401202,2023,821,339,41.290001,306,33
1400000US06037401203,6037401203,2023,223,139,62.330002,128,11
1400000US06037401311,6037401311,2023,1064,356,33.459999,295,61
1400000US06037401312,6037401312,2023,2145,781,36.41,730,51
1400000US06037401601,6037401601,2023,444,134,30.18,125,9
1400000US06037401602,6037401602,2023,2609,854,32.73,796,58
1400000US06037401705,6037401705,2023,449,185,41.200001,165,20
1400000US06037401707,6037401707,2023,314,292,92.989998,265,27
1400000US06037401801,6037401801,2023,606,148,24.42,117,31
1400000US06037401802,6037401802,2023,2835,864,30.48,745,119
1400000US06037401902,6037401902,2023,1713,556,32.459999,475,81
1400000US06037402001,6037402001,2023,322,161,50,149,12
1400000US06037402002,6037402002,2023,324,131,40.43,117,14
1400000US06037402101,6037402101,2023,297,284,95.620003,255,29
1400000US06037402102,6037402102,2023,1652,1562,94.550003,1357,205
1400000US06037402200,6037402200,2023,343,304,88.629997,255,49
1400000US06037402301,6037402301,2023,1037,981,94.599998,872,109
1400000US06037402303,6037402303,2023,299,279,93.309998,252,27
1400000US06037402403,6037402403,2023,911,513,56.310001,457,56
1400000US06037402405,6037402405,2023,909,869,95.599998,764,105
1400000US06037402406,6037402406,2023,903,875,96.900002,800,75
1400000US06037402501,6037402501,2023,1018,983,96.559998,889,94
1400000US06037402503,6037402503,2023,768,734,95.57,641,93
1400000US06037402504,6037402504,2023,373,362,97.050003,327,35
1400000US06037402601,6037402601,2023,703,675,96.019997,629,46
1400000US06037402702,6037402702,2023,1567,1290,82.32,1068,222
1400000US06037402703,6037402703,2023,448,429,95.760002,360,69
1400000US06037402705,6037402705,2023,521,498,95.589996,442,56
1400000US06037402902,6037402902,2023,518,493,95.169998,431,62
1400000US06037402903,6037402903,2023,1287,1241,96.43,1110,131
1400000US06037403000,6037403000,2023,2795,2701,96.639999,2325,376
1400000US06037403316,6037403316,2023,623,491,78.809998,363,128
1400000US06037403317,6037403317,2023,1945,1467,75.419998,1104,363
1400000US06037403318,6037403318,2023,426,328,77,249,79
1400000US06037403320,6037403320,2023,466,238,51.07,156,82
1400000US06037403321,6037403321,2023,413,295,71.43,225,70
1400000US06037403323,6037403323,2023,1659,380,22.91,371,9
1400000US06037403324,6037403324,2023,665,170,25.559999,161,9
1400000US06037403325,6037403325,2023,3854,953,24.73,888,65
1400000US06037403326,6037403326,2023,671,187,27.870001,178,9
1400000US06037403327,6037403327,2023,251,168,66.93,124,44
1400000US06037403401,6037403401,2023,464,143,30.82,134,9
1400000US06037403402,6037403402,2023,2755,740,26.860001,690,50
1400000US06037403404,6037403404,2023,1120,282,25.18,263,19
1400000US06037403407,6037403407,2023,608,149,24.51,142,7
1400000US06037403408,6037403408,2023,854,494,57.849998,384,110
1400000US06037403409,6037403409,2023,565,181,32.040001,156,25
1400000US06037403601,6037403601,2023,770,493,64.029999,424,69
1400000US06037403702,6037403702,2023,1723,1043,60.529999,856,187
1400000US06037403703,6037403703,2023,375,225,60,209,16
1400000US06037403722,6037403722,2023,716,472,65.919998,402,70
1400000US06037403801,6037403801,2023,952,651,68.379997,584,67
1400000US06037403901,6037403901,2023,57,40,70.18,31,9
1400000US06037403902,6037403902,2023,340,180,52.939999,160,20
1400000US06037404000,6037404000,2023,543,482,88.769997,416,66
1400000US06037404100,6037404100,2023,263,250,95.059998,233,17
1400000US06037404201,6037404201,2023,1809,1626,89.879997,1431,195
1400000US06037404203,6037404203,2023,208,172,82.690002,155,17
1400000US06037404401,6037404401,2023,372,333,89.519997,281,52
1400000US06037404402,6037404402,2023,614,523,85.18,444,79
1400000US06037404503,6037404503,2023,489,422,86.300003,375,47
1400000US06037404504,6037404504,2023,447,400,89.489998,361,39
1400000US06037404600,6037404600,2023,745,581,77.989998,509,72
1400000US06037404701,6037404701,2023,419,372,88.779999,340,32
1400000US06037404702,6037404702,2023,519,470,90.559998,410,60
1400000US06037404804,6037404804,2023,2524,2154,85.339996,1881,273
1400000US06037404805,6037404805,2023,435,367,84.370003,313,54
1400000US06037404806,6037404806,2023,871,777,89.209999,679,98
1400000US06037404901,6037404901,2023,394,353,89.589996,298,55
1400000US06037404903,6037404903,2023,324,286,88.269997,260,26
1400000US06037405001,6037405001,2023,788,703,89.209999,621,82
1400000US06037405002,6037405002,2023,223,215,96.410004,187,28
1400000US06037405101,6037405101,2023,1282,1137,88.690002,1013,124
1400000US06037405201,6037405201,2023,1666,1435,86.129997,1242,193
1400000US06037405202,6037405202,2023,541,500,92.419998,453,47
1400000US06037405302,6037405302,2023,401,287,71.57,255,32
1400000US06037405400,6037405400,2023,414,261,63.040001,238,23
1400000US06037405600,6037405600,2023,951,648,68.139999,569,79
1400000US06037405701,6037405701,2023,802,614,76.559998,539,75
1400000US06037405702,6037405702,2023,1279,907,70.910004,766,141
1400000US06037405800,6037405800,2023,981,855,87.160004,742,113
1400000US06037406000,6037406000,2023,1630,1093,67.059998,956,137
1400000US06037406103,6037406103,2023,542,368,67.900002,326,42
1400000US06037406201,6037406201,2023,1062,765,72.029999,661,104
1400000US06037406300,6037406300,2023,2379,1217,51.16,1009,208
1400000US06037406413,6037406413,2023,1316,855,64.970001,745,110
1400000US06037406601,6037406601,2023,3258,2340,71.82,2040,300
1400000US06037406602,6037406602,2023,306,239,78.099998,211,28
1400000US06037406701,6037406701,2023,219,178,81.279999,152,26
1400000US06037406702,6037406702,2023,200,146,73,129,17
1400000US06037406801,6037406801,2023,1976,1373,69.480003,1200,173
1400000US06037406903,6037406903,2023,2094,1363,65.089996,1140,223
1400000US06037407001,6037407001,2023,321,302,94.080002,278,24
1400000US06037407002,6037407002,2023,329,307,93.309998,286,21
1400000US06037407101,6037407101,2023,1437,1231,85.660004,1124,107
1400000US06037407201,6037407201,2023,305,230,75.410004,211,19
1400000US06037407301,6037407301,2023,316,240,75.949997,222,18
1400000US06037407302,6037407302,2023,787,610,77.510002,563,47
1400000US06037407501,6037407501,2023,742,559,75.339996,474,85
1400000US06037407502,6037407502,2023,567,434,76.540001,381,53
1400000US06037407602,6037407602,2023,426,310,72.769997,285,25
1400000US06037407701,6037407701,2023,404,357,88.370003,341,16
1400000US06037407702,6037407702,2023,1262,1064,84.309998,930,134
1400000US06037407801,6037407801,2023,392,295,75.260002,257,38
1400000US06037407802,6037407802,2023,2907,2392,82.279999,2105,287
1400000US06037407901,6037407901,2023,512,365,71.290001,308,57
1400000US06037408003,6037408003,2023,89,71,79.779999,64,7
1400000US06037408135,6037408135,2023,489,445,91,418,27
1400000US06037408136,6037408136,2023,352,271,76.989998,238,33
1400000US06037408137,6037408137,2023,625,527,84.32,458,69
1400000US06037408138,6037408138,2023,301,286,95.019997,259,27
1400000US06037408139,6037408139,2023,365,344,94.25,314,30
1400000US06037408140,6037408140,2023,532,486,91.349998,461,25
1400000US06037408141,6037408141,2023,2031,1724,84.879997,1570,154
1400000US06037408212,6037408212,2023,575,388,67.480003,310,78
1400000US06037408213,6037408213,2023,358,295,82.400002,267,28
1400000US06037408301,6037408301,2023,540,505,93.519997,484,21
1400000US06037408302,6037408302,2023,561,270,48.130001,215,55
1400000US06037408401,6037408401,2023,3,1,33.330002,1,0
1400000US06037408402,6037408402,2023,734,537,73.160004,466,71
1400000US06037408503,6037408503,2023,852,457,53.639999,342,115
1400000US06037408504,6037408504,2023,575,304,52.869999,250,54
1400000US06037408505,6037408505,2023,1801,1273,70.68,980,293
1400000US06037408623,6037408623,2023,2073,1276,61.549999,921,355
1400000US06037408624,6037408624,2023,211,190,90.050003,156,34
1400000US06037408625,6037408625,2023,1708,859,50.290001,649,210
1400000US06037408631,6037408631,2023,593,396,66.779999,338,58
1400000US06037408705,6037408705,2023,2866,1966,68.599998,1654,312
1400000US06037408707,6037408707,2023,879,230,26.17,208,22
1400000US06037408722,6037408722,2023,654,464,70.949997,377,87
1400000US06037408724,6037408724,2023,415,379,91.330002,355,24
1400000US06037408725,6037408725,2023,648,471,72.690002,402,69
1400000US06037408800,6037408800,2023,659,500,75.870003,500,0
1400000US06037408900,6037408900,2023,1739,646,37.150002,609,37
1400000US06037409000,6037409000,2023,569,520,91.389999,460,60
1400000US06037409100,6037409100,2023,244,203,83.199997,184,19
1400000US06037430003,6037430003,2023,354,159,44.919998,144,15
1400000US06037430101,6037430101,2023,1837,714,38.869999,664,50
1400000US06037430102,6037430102,2023,466,322,69.099998,296,26
1400000US06037430200,6037430200,2023,872,342,39.220001,318,24
1400000US06037430302,6037430302,2023,486,174,35.799999,157,17
1400000US06037430400,6037430400,2023,1255,294,23.43,264,30
1400000US06037430502,6037430502,2023,1204,480,39.869999,300,180
1400000US06037430701,6037430701,2023,539,190,35.25,169,21
1400000US06037430721,6037430721,2023,2963,869,29.33,784,85
1400000US06037430801,6037430801,2023,747,262,35.07,246,16
1400000US06037430802,6037430802,2023,1257,410,32.619999,367,43
1400000US06037431002,6037431002,2023,498,270,54.220001,263,7
1400000US06037431003,6037431003,2023,1502,721,48,667,54
1400000US06037431004,6037431004,2023,1473,714,48.470001,657,57
1400000US06037431100,6037431100,2023,431,273,63.34,246,27
1400000US06037431200,6037431200,2023,417,299,71.699997,285,14
1400000US06037431400,6037431400,2023,518,255,49.23,224,31
1400000US06037431501,6037431501,2023,323,215,66.559998,136,79
1400000US06037431502,6037431502,2023,652,516,79.139999,317,199
1400000US06037431600,6037431600,2023,493,168,34.080002,149,19
1400000US06037431701,6037431701,2023,1380,523,37.900002,465,58
1400000US06037431800,6037431800,2023,1825,669,36.66,622,47
1400000US06037431900,6037431900,2023,840,350,41.669998,338,12
1400000US06037432002,6037432002,2023,507,218,43,196,22
1400000US06037432102,6037432102,2023,517,216,41.779999,207,9
1400000US06037432201,6037432201,2023,448,316,70.540001,269,47
1400000US06037432202,6037432202,2023,2457,1920,78.139999,1351,569
1400000US06037432300,6037432300,2023,751,614,81.760002,414,200
1400000US06037432401,6037432401,2023,2337,1930,82.580002,1235,695
1400000US06037432402,6037432402,2023,483,410,84.889999,275,135
1400000US06037432501,6037432501,2023,289,229,79.239998,156,73
1400000US06037432602,6037432602,2023,1346,1068,79.349998,750,318
1400000US06037432700,6037432700,2023,44,35,79.550003,29,6
1400000US06037432801,6037432801,2023,475,418,88,306,112
1400000US06037432902,6037432902,2023,374,293,78.339996,251,42
1400000US06037433103,6037433103,2023,335,313,93.43,227,86
1400000US06037433200,6037433200,2023,2478,2237,90.269997,1544,693
1400000US06037433305,6037433305,2023,626,496,79.230003,488,8
1400000US06037433307,6037433307,2023,866,674,77.830002,631,43
1400000US06037433505,6037433505,2023,977,919,94.059998,602,317
1400000US06037433803,6037433803,2023,1818,1449,79.699997,1064,385
1400000US06037433804,6037433804,2023,1311,1056,80.550003,995,61
1400000US06037433901,6037433901,2023,562,436,77.580002,428,8
1400000US06037433903,6037433903,2023,1014,863,85.110001,818,45
1400000US06037434001,6037434001,2023,1232,1156,93.830002,802,354
1400000US06037434003,6037434003,2023,467,336,71.949997,326,10
1400000US06037434100,6037434100,2023,330,224,67.879997,206,18
1400000US06037460002,6037460002,2023,373,217,58.18,161,56
1400000US06037460101,6037460101,2023,330,70,21.209999,65,5
1400000US06037460200,6037460200,2023,152,99,65.129997,94,5
1400000US06037460301,6037460301,2023,357,158,44.259998,152,6
1400000US06037460302,6037460302,2023,461,108,23.43,98,10
1400000US06037460501,6037460501,2023,657,31,4.7199998,31,0
1400000US06037460502,6037460502,2023,595,36,6.0500002,35,1
1400000US06037460601,6037460601,2023,583,25,4.29,24,1
1400000US06037460700,6037460700,2023,1949,101,5.1799998,101,0
1400000US06037460900,6037460900,2023,1318,937,71.089996,839,98
1400000US06037461000,6037461000,2023,620,391,63.060001,335,56
1400000US06037461100,6037461100,2023,457,305,66.739998,264,41
1400000US06037461200,6037461200,2023,423,357,84.400002,320,37
1400000US06037461300,6037461300,2023,289,208,71.970001,185,23
1400000US06037461400,6037461400,2023,514,434,84.440002,369,65
1400000US06037461502,6037461502,2023,906,781,86.199997,722,59
1400000US06037462100,6037462100,2023,414,371,89.610001,358,13
1400000US06037462500,6037462500,2023,2077,1571,75.639999,1301,270
1400000US06037462600,6037462600,2023,1833,1421,77.519997,1144,277
1400000US06037462900,6037462900,2023,114,102,89.470001,95,7
1400000US06037463000,6037463000,2023,412,172,41.75,97,75
1400000US06037463200,6037463200,2023,457,316,69.150002,273,43
1400000US06037463300,6037463300,2023,481,248,51.560001,186,62
1400000US06037463601,6037463601,2023,783,654,83.519997,594,60
1400000US06037463800,6037463800,2023,385,146,37.919998,111,35
1400000US06037464000,6037464000,2023,1086,720,66.300003,604,116
1400000US06037464101,6037464101,2023,1282,116,9.0500002,110,6
1400000US06037464200,6037464200,2023,791,75,9.4799995,75,0
1400000US06037480002,6037480002,2023,971,225,23.17,188,37
1400000US06037480012,6037480012,2023,1420,531,37.389999,485,46
1400000US06037480201,6037480201,2023,255,143,56.080002,117,26
1400000US06037480202,6037480202,2023,466,286,61.369999,218,68
1400000US06037480302,6037480302,2023,359,210,58.5,195,15
1400000US06037480304,6037480304,2023,2863,1648,57.560001,1453,195
1400000US06037480400,6037480400,2023,1489,792,53.189999,695,97
1400000US06037480500,6037480500,2023,1830,289,15.79,283,6
1400000US06037480702,6037480702,2023,556,84,15.11,81,3
1400000US06037480703,6037480703,2023,701,118,16.83,112,6
1400000US06037480704,6037480704,2023,1448,219,15.12,215,4
1400000US06037480803,6037480803,2023,354,176,49.720001,152,24
1400000US06037480804,6037480804,2023,629,331,52.619999,309,22
1400000US06037480901,6037480901,2023,85,49,57.650002,48,1
1400000US06037480903,6037480903,2023,491,298,60.689999,273,25
1400000US06037481101,6037481101,2023,294,219,74.489998,181,38
1400000US06037481102,6037481102,2023,39,31,79.489998,28,3
1400000US06037481103,6037481103,2023,1798,1206,67.07,1111,95
1400000US06037481203,6037481203,2023,1255,932,74.260002,762,170
1400000US06037481300,6037481300,2023,579,373,64.419998,300,73
1400000US06037481401,6037481401,2023,546,408,74.730003,319,89
1400000US06037481403,6037481403,2023,372,252,67.739998,238,14
1400000US06037481404,6037481404,2023,1506,1034,68.660004,803,231
1400000US06037481500,6037481500,2023,2191,1067,48.700001,903,164
1400000US06037481606,6037481606,2023,682,413,60.560001,368,45
1400000US06037481901,6037481901,2023,602,276,45.849998,252,24
1400000US06037482001,6037482001,2023,915,355,38.799999,288,67
1400000US06037482002,6037482002,2023,794,263,33.119999,227,36
1400000US06037482101,6037482101,2023,661,475,71.860001,422,53
1400000US06037482102,6037482102,2023,682,300,43.990002,251,49
1400000US06037482202,6037482202,2023,545,299,54.860001,289,10
1400000US06037482303,6037482303,2023,218,182,83.489998,165,17
1400000US06037482304,6037482304,2023,427,317,74.239998,300,17
1400000US06037482401,6037482401,2023,289,199,68.860001,194,5
1400000US06037482403,6037482403,2023,909,653,71.839996,612,41
1400000US06037482502,6037482502,2023,1009,712,70.559998,665,47
1400000US06037482522,6037482522,2023,373,161,43.16,145,16
1400000US06037482600,6037482600,2023,415,250,60.240002,214,36
1400000US06037482701,6037482701,2023,480,336,70,283,53
1400000US06037482801,6037482801,2023,526,334,63.5,300,34
1400000US06037500202,6037500202,2023,3546,2138,60.290001,1526,612
1400000US06037500203,6037500203,2023,516,93,18.02,87,6
1400000US06037500300,6037500300,2023,310,189,60.970001,150,39
1400000US06037500402,6037500402,2023,499,432,86.57,361,71
1400000US06037500404,6037500404,2023,331,262,79.150002,227,35
1400000US06037500600,6037500600,2023,583,493,84.559998,425,68
1400000US06037500700,6037500700,2023,411,313,76.160004,249,64
1400000US06037500800,6037500800,2023,2720,2025,74.449997,1652,373
1400000US06037500900,6037500900,2023,478,384,80.330002,333,51
1400000US06037501001,6037501001,2023,339,208,61.360001,179,29
1400000US06037501002,6037501002,2023,1385,986,71.190002,794,192
1400000US06037501200,6037501200,2023,405,272,67.160004,232,40
1400000US06037501302,6037501302,2023,1142,829,72.589996,726,103
1400000US06037501400,6037501400,2023,1757,1493,84.970001,1211,282
1400000US06037501600,6037501600,2023,353,245,69.410004,215,30
1400000US06037501700,6037501700,2023,639,213,33.330002,181,32
1400000US06037501804,6037501804,2023,352,265,75.279999,247,18
1400000US06037502003,6037502003,2023,378,333,88.099998,298,35
1400000US06037502005,6037502005,2023,463,389,84.019997,300,89
1400000US06037502200,6037502200,2023,518,262,50.580002,209,53
1400000US06037502303,6037502303,2023,2072,1752,84.559998,1511,241
1400000US06037502401,6037502401,2023,1062,867,81.639999,699,168
1400000US06037502602,6037502602,2023,375,302,80.529999,253,49
1400000US06037502603,6037502603,2023,538,440,81.779999,338,102
1400000US06037502604,6037502604,2023,293,248,84.639999,197,51
1400000US06037502700,6037502700,2023,610,451,73.93,379,72
1400000US06037502801,6037502801,2023,3140,2232,71.080002,1701,531
1400000US06037503103,6037503103,2023,385,354,91.949997,306,48
1400000US06037503105,6037503105,2023,472,434,91.949997,383,51
1400000US06037503201,6037503201,2023,435,297,68.279999,240,57
1400000US06037503202,6037503202,2023,384,331,86.199997,275,56
1400000US06037503302,6037503302,2023,2948,2335,79.209999,1815,520
1400000US06037503401,6037503401,2023,417,255,61.150002,185,70
1400000US06037503402,6037503402,2023,541,150,27.73,134,16
1400000US06037503501,6037503501,2023,861,588,68.290001,476,112
1400000US06037503502,6037503502,2023,580,463,79.830002,367,96
1400000US06037503602,6037503602,2023,2411,1133,46.990002,1040,93
1400000US06037503701,6037503701,2023,1593,660,41.43,561,99
1400000US06037503702,6037503702,2023,1228,686,55.860001,460,226
1400000US06037503705,6037503705,2023,253,125,49.41,122,3
1400000US06037503801,6037503801,2023,539,333,61.779999,322,11
1400000US06037503802,6037503802,2023,291,133,45.700001,124,9
1400000US06037503902,6037503902,2023,417,176,42.209999,170,6
1400000US06037504002,6037504002,2023,1390,618,44.459999,586,32
1400000US06037504101,6037504101,2023,242,176,72.730003,168,8
1400000US06037504200,6037504200,2023,1622,1491,91.919998,1291,200
1400000US06037530005,6037530005,2023,2207,1303,59.040001,1195,108
1400000US06037530007,6037530007,2023,1453,965,66.410004,886,79
1400000US06037530101,6037530101,2023,302,232,76.82,219,13
1400000US06037530102,6037530102,2023,3515,2506,71.290001,2353,153
1400000US06037530202,6037530202,2023,618,455,73.620003,435,20
1400000US06037530203,6037530203,2023,457,316,69.150002,302,14
1400000US06037530301,6037530301,2023,3068,2807,91.489998,2691,116
1400000US06037530400,6037530400,2023,1631,1385,84.919998,1219,166
1400000US06037530500,6037530500,2023,512,474,92.580002,449,25
1400000US06037530603,6037530603,2023,527,449,85.199997,425,24
1400000US06037530700,6037530700,2023,562,498,88.610001,447,51
1400000US06037530801,6037530801,2023,276,266,96.379997,256,10
1400000US06037530902,6037530902,2023,473,453,95.769997,442,11
1400000US06037531000,6037531000,2023,2929,2724,93,2604,120
1400000US06037531101,6037531101,2023,2412,2140,88.720001,2060,80
1400000US06037531102,6037531102,2023,727,703,96.699997,680,23
1400000US06037531201,6037531201,2023,629,606,96.339996,590,16
1400000US06037531202,6037531202,2023,93,90,96.769997,86,4
1400000US06037531302,6037531302,2023,1051,982,93.43,908,74
1400000US06037531502,6037531502,2023,790,744,94.18,726,18
1400000US06037531503,6037531503,2023,389,373,95.889999,355,18
1400000US06037531603,6037531603,2023,1189,1106,93.019997,1070,36
1400000US06037531604,6037531604,2023,255,243,95.290001,220,23
1400000US06037531701,6037531701,2023,544,433,79.599998,383,50
1400000US06037531702,6037531702,2023,423,340,80.379997,327,13
1400000US06037531800,6037531800,2023,646,480,74.300003,444,36
1400000US06037531902,6037531902,2023,377,318,84.349998,290,28
1400000US06037532002,6037532002,2023,421,315,74.82,291,24
1400000US06037532101,6037532101,2023,30,21,70,21,0
1400000US06037532102,6037532102,2023,747,645,86.349998,595,50
1400000US06037532200,6037532200,2023,244,209,85.660004,186,23
1400000US06037532302,6037532302,2023,300,216,72,210,6
1400000US06037532303,6037532303,2023,636,464,72.959999,403,61
1400000US06037532500,6037532500,2023,2868,2690,93.790001,2577,113
1400000US06037532605,6037532605,2023,291,286,98.279999,270,16
1400000US06037532607,6037532607,2023,1916,1847,96.400002,1791,56
1400000US06037532700,6037532700,2023,787,761,96.699997,730,31
1400000US06037532800,6037532800,2023,2519,2477,98.330002,2439,38
1400000US06037532900,6037532900,2023,1469,1443,98.230003,1415,28
1400000US06037533103,6037533103,2023,2523,2151,85.260002,2091,60
1400000US06037533108,6037533108,2023,2026,1939,95.709999,1869,70
1400000US06037533201,6037533201,2023,431,410,95.129997,394,16
1400000US06037533204,6037533204,2023,444,406,91.440002,388,18
1400000US06037533402,6037533402,2023,1232,1183,96.019997,1124,59
1400000US06037533403,6037533403,2023,1434,1378,96.089996,1332,46
1400000US06037533501,6037533501,2023,1177,1126,95.669998,1078,48
1400000US06037533504,6037533504,2023,727,630,86.660004,590,40
1400000US06037533601,6037533601,2023,632,605,95.730003,575,30
1400000US06037533602,6037533602,2023,1876,1741,92.800003,1663,78
1400000US06037533603,6037533603,2023,2322,2213,95.309998,2100,113
1400000US06037533701,6037533701,2023,1144,1063,92.919998,1008,55
1400000US06037533703,6037533703,2023,454,425,93.610001,406,19
1400000US06037533804,6037533804,2023,544,504,92.650002,474,30
1400000US06037533901,6037533901,2023,2909,2436,83.739998,2226,210
1400000US06037533902,6037533902,2023,483,404,83.639999,371,33
1400000US06037534001,6037534001,2023,704,538,76.419998,502,36
1400000US06037534002,6037534002,2023,602,466,77.410004,443,23
1400000US06037534102,6037534102,2023,858,647,75.410004,607,40
1400000US06037534201,6037534201,2023,685,570,83.209999,535,35
1400000US06037534302,6037534302,2023,307,294,95.769997,279,15
1400000US06037534404,6037534404,2023,1030,975,94.660004,940,35
1400000US06037534405,6037534405,2023,1342,1311,97.690002,1286,25
1400000US06037534406,6037534406,2023,1115,1072,96.139999,1035,37
1400000US06037534501,6037534501,2023,726,680,93.660004,652,28
1400000US06037534803,6037534803,2023,514,489,95.139999,472,17
1400000US06037534804,6037534804,2023,437,406,92.910004,381,25
1400000US06037534900,6037534900,2023,2287,2156,94.269997,1997,159
1400000US06037535001,6037535001,2023,1401,1376,98.220001,1352,24
1400000US06037535101,6037535101,2023,2674,2603,97.339996,2504,99
1400000US06037535102,6037535102,2023,489,482,98.57,465,17
1400000US06037535300,6037535300,2023,1109,1059,95.489998,999,60
1400000US06037535501,6037535501,2023,429,411,95.800003,397,14
1400000US06037535603,6037535603,2023,432,414,95.830002,396,18
1400000US06037535604,6037535604,2023,397,385,96.980003,371,14
1400000US06037535605,6037535605,2023,1615,1430,88.540001,1271,159
1400000US06037535607,6037535607,2023,3873,3670,94.760002,3522,148
1400000US06037535701,6037535701,2023,415,401,96.629997,379,22
1400000US06037535702,6037535702,2023,2401,2264,94.290001,2141,123
1400000US06037535803,6037535803,2023,293,283,96.589996,277,6
1400000US06037535901,6037535901,2023,1316,1177,89.440002,1088,89
1400000US06037536000,6037536000,2023,2007,1787,89.040001,1691,96
1400000US06037536103,6037536103,2023,438,388,88.580002,362,26
1400000US06037536104,6037536104,2023,1897,1708,90.040001,1586,122
1400000US06037536201,6037536201,2023,787,698,88.690002,569,129
1400000US06037540000,6037540000,2023,2555,2377,93.029999,2105,272
1400000US06037540101,6037540101,2023,2763,2565,92.830002,2306,259
1400000US06037540202,6037540202,2023,1906,1775,93.129997,1586,189
1400000US06037540203,6037540203,2023,951,885,93.059998,816,69
1400000US06037540300,6037540300,2023,497,466,93.760002,424,42
1400000US06037540400,6037540400,2023,280,274,97.860001,270,4
1400000US06037540502,6037540502,2023,556,491,88.309998,452,39
1400000US06037540600,6037540600,2023,326,240,73.620003,239,1
1400000US06037540700,6037540700,2023,2031,1748,86.07,1658,90
1400000US06037540800,6037540800,2023,1277,1148,89.900002,1085,63
1400000US06037540901,6037540901,2023,560,543,96.959999,529,14
1400000US06037540902,6037540902,2023,1578,1374,87.07,1281,93
1400000US06037541003,6037541003,2023,467,354,75.800003,320,34
1400000US06037541100,6037541100,2023,404,271,67.080002,271,0
1400000US06037541200,6037541200,2023,902,575,63.75,564,11
1400000US06037541300,6037541300,2023,1451,842,58.029999,835,7
1400000US06037541401,6037541401,2023,452,288,63.720001,288,0
1400000US06037541500,6037541500,2023,705,476,67.519997,472,4
1400000US06037541603,6037541603,2023,786,652,82.949997,611,41
1400000US06037541605,6037541605,2023,461,304,65.940002,301,3
1400000US06037541700,6037541700,2023,2085,1930,92.57,1766,164
1400000US06037541802,6037541802,2023,436,405,92.889999,357,48
1400000US06037542000,6037542000,2023,986,676,68.559998,668,8
1400000US06037542104,6037542104,2023,473,297,62.790001,297,0
1400000US06037542106,6037542106,2023,2810,1726,61.419998,1716,10
1400000US06037542200,6037542200,2023,729,460,63.099998,457,3
1400000US06037542401,6037542401,2023,840,730,86.900002,696,34
1400000US06037542402,6037542402,2023,1886,1173,62.200001,1163,10
1400000US06037542502,6037542502,2023,17,11,64.709999,11,0
1400000US06037542601,6037542601,2023,478,318,66.529999,314,4
1400000US06037542700,6037542700,2023,1087,703,64.669998,698,5
1400000US06037542800,6037542800,2023,615,383,62.279999,377,6
1400000US06037542900,6037542900,2023,389,215,55.27,215,0
1400000US06037543000,6037543000,2023,601,373,62.060001,366,7
1400000US06037543100,6037543100,2023,752,480,63.830002,474,6
1400000US06037543201,6037543201,2023,584,361,61.82,361,0
1400000US06037543203,6037543203,2023,216,131,60.650002,128,3
1400000US06037543304,6037543304,2023,252,220,87.300003,210,10
1400000US06037543306,6037543306,2023,282,219,77.660004,197,22
1400000US06037543321,6037543321,2023,667,198,29.690001,190,8
1400000US06037543322,6037543322,2023,1153,886,76.839996,843,43
1400000US06037543400,6037543400,2023,272,215,79.040001,170,45
1400000US06037543501,6037543501,2023,1384,1115,80.559998,988,127
1400000US06037543503,6037543503,2023,867,759,87.540001,724,35
1400000US06037543601,6037543601,2023,660,484,73.330002,426,58
1400000US06037543607,6037543607,2023,380,218,57.369999,178,40
1400000US06037543701,6037543701,2023,2800,2160,77.139999,1888,272
1400000US06037543705,6037543705,2023,414,375,90.580002,356,19
1400000US06037543801,6037543801,2023,607,477,78.580002,433,44
1400000US06037543903,6037543903,2023,1188,949,79.879997,842,107
1400000US06037544001,6037544001,2023,408,351,86.029999,333,18
1400000US06037544002,6037544002,2023,764,603,78.93,566,37
1400000US06037550101,6037550101,2023,304,231,75.989998,172,59
1400000US06037550201,6037550201,2023,220,188,85.449997,139,49
1400000US06037550202,6037550202,2023,341,268,78.589996,206,62
1400000US06037550301,6037550301,2023,430,326,75.809998,247,79
1400000US06037550501,6037550501,2023,625,426,68.160004,360,66
1400000US06037550602,6037550602,2023,738,461,62.470001,388,73
1400000US06037550700,6037550700,2023,2042,1353,66.260002,1100,253
1400000US06037550801,6037550801,2023,794,589,74.18,479,110
1400000US06037550901,6037550901,2023,4003,2739,68.419998,2176,563
1400000US06037551001,6037551001,2023,731,472,64.57,390,82
1400000US06037551002,6037551002,2023,1327,926,69.779999,733,193
1400000US06037551101,6037551101,2023,561,454,80.93,385,69
1400000US06037551102,6037551102,2023,417,335,80.339996,282,53
1400000US06037551201,6037551201,2023,547,393,71.849998,340,53
1400000US06037551203,6037551203,2023,1122,883,78.699997,758,125
1400000US06037551204,6037551204,2023,732,571,78.010002,489,82
1400000US06037551300,6037551300,2023,3404,2375,69.769997,1870,505
1400000US06037551402,6037551402,2023,600,422,70.330002,354,68
1400000US06037551501,6037551501,2023,1989,1461,73.449997,1202,259
1400000US06037551700,6037551700,2023,553,451,81.559998,380,71
1400000US06037551801,6037551801,2023,489,216,44.169998,162,54
1400000US06037551802,6037551802,2023,822,558,67.879997,462,96
1400000US06037551900,6037551900,2023,303,251,82.839996,249,2
1400000US06037552001,6037552001,2023,339,245,72.269997,239,6
1400000US06037552100,6037552100,2023,3198,2232,69.790001,2117,115
1400000US06037552301,6037552301,2023,523,411,78.589996,399,12
1400000US06037552302,6037552302,2023,1029,779,75.699997,732,47
1400000US06037552601,6037552601,2023,379,305,80.470001,296,9
1400000US06037552602,6037552602,2023,537,408,75.980003,389,19
1400000US06037552700,6037552700,2023,568,439,77.290001,419,20
1400000US06037552800,6037552800,2023,1830,1300,71.040001,1241,59
1400000US06037553000,6037553000,2023,403,293,72.699997,288,5
1400000US06037553100,6037553100,2023,2407,1982,82.339996,1635,347
1400000US06037553300,6037553300,2023,281,240,85.410004,211,29
1400000US06037553502,6037553502,2023,4647,4370,94.040001,3683,687
1400000US06037553504,6037553504,2023,525,498,94.860001,438,60
1400000US06037553601,6037553601,2023,449,417,92.870003,369,48
1400000US06037553701,6037553701,2023,372,352,94.620003,305,47
1400000US06037553702,6037553702,2023,1126,1072,95.199997,944,128
1400000US06037553802,6037553802,2023,1009,945,93.660004,813,132
1400000US06037553901,6037553901,2023,908,823,90.639999,671,152
1400000US06037553902,6037553902,2023,1302,1205,92.550003,1034,171
1400000US06037554002,6037554002,2023,639,540,84.510002,487,53
1400000US06037554106,6037554106,2023,462,417,90.260002,349,68
1400000US06037554201,6037554201,2023,619,521,84.169998,451,70
1400000US06037554405,6037554405,2023,734,571,77.790001,480,91
1400000US06037554511,6037554511,2023,1650,589,35.700001,402,187
1400000US06037554512,6037554512,2023,1527,470,30.780001,304,166
1400000US06037554514,6037554514,2023,510,357,70,307,50
1400000US06037554515,6037554515,2023,711,332,46.689999,229,103
1400000US06037554516,6037554516,2023,3681,1738,47.220001,1190,548
1400000US06037554517,6037554517,2023,738,231,31.299999,144,87
1400000US06037554518,6037554518,2023,626,194,30.99,120,74
1400000US06037554521,6037554521,2023,1666,971,58.279999,749,222
1400000US06037554522,6037554522,2023,1074,608,56.610001,455,153
1400000US06037554700,6037554700,2023,248,221,89.110001,214,7
1400000US06037554801,6037554801,2023,636,478,75.160004,391,87
1400000US06037554802,6037554802,2023,1302,878,67.43,690,188
1400000US06037555001,6037555001,2023,370,288,77.839996,265,23
1400000US06037555002,6037555002,2023,297,234,78.790001,215,19
1400000US06037555105,6037555105,2023,1826,1529,83.730003,1303,226
1400000US06037555106,6037555106,2023,404,355,87.870003,327,28
1400000US06037555107,6037555107,2023,327,303,92.660004,280,23
1400000US06037555211,6037555211,2023,292,282,96.580002,259,23
1400000US06037555212,6037555212,2023,281,240,85.410004,234,6
1400000US06037555300,6037555300,2023,296,245,82.769997,181,64
1400000US06037570001,6037570001,2023,3108,2157,69.400002,1693,464
1400000US06037570002,6037570002,2023,442,395,89.370003,346,49
1400000US06037570100,6037570100,2023,525,481,91.620003,425,56
1400000US06037570202,6037570202,2023,820,564,68.779999,551,13
1400000US06037570203,6037570203,2023,503,368,73.160004,362,6
1400000US06037570402,6037570402,2023,794,578,72.800003,558,20
1400000US06037570403,6037570403,2023,611,418,68.410004,411,7
1400000US06037570504,6037570504,2023,3110,2026,65.139999,1982,44
1400000US06037570601,6037570601,2023,408,312,76.470001,301,11
1400000US06037570602,6037570602,2023,786,546,69.470001,528,18
1400000US06037570701,6037570701,2023,1091,853,78.190002,703,150
1400000US06037570800,6037570800,2023,1101,698,63.400002,487,211
1400000US06037570902,6037570902,2023,326,134,41.099998,127,7
1400000US06037571000,6037571000,2023,435,106,24.370001,99,7
1400000US06037571101,6037571101,2023,288,103,35.759998,100,3
1400000US06037571102,6037571102,2023,2701,1391,51.5,1332,59
1400000US06037571202,6037571202,2023,1266,563,44.470001,534,29
1400000US06037571300,6037571300,2023,962,566,58.84,543,23
1400000US06037571400,6037571400,2023,373,158,42.360001,148,10
1400000US06037571502,6037571502,2023,443,320,72.230003,312,8
1400000US06037571701,6037571701,2023,1451,1026,70.709999,1001,25
1400000US06037571703,6037571703,2023,755,552,73.110001,548,4
1400000US06037571800,6037571800,2023,442,154,34.84,126,28
1400000US06037571900,6037571900,2023,2229,958,42.98,899,59
1400000US06037572202,6037572202,2023,1188,853,71.800003,833,20
1400000US06037572500,6037572500,2023,541,360,66.540001,352,8
1400000US06037572600,6037572600,2023,741,518,69.910004,502,16
1400000US06037572700,6037572700,2023,556,386,69.419998,372,14
1400000US06037573101,6037573101,2023,849,561,66.080002,553,8
1400000US06037573201,6037573201,2023,652,484,74.230003,479,5
1400000US06037573300,6037573300,2023,371,223,60.110001,221,2
1400000US06037573402,6037573402,2023,1474,1013,68.720001,982,31
1400000US06037573601,6037573601,2023,339,99,29.200001,97,2
1400000US06037573700,6037573700,2023,798,149,18.67,139,10
1400000US06037573800,6037573800,2023,1174,394,33.560001,370,24
1400000US06037573902,6037573902,2023,790,130,16.459999,128,2
1400000US06037574000,6037574000,2023,939,245,26.09,235,10
1400000US06037574100,6037574100,2023,1390,424,30.5,391,33
1400000US06037574201,6037574201,2023,513,154,30.02,151,3
1400000US06037574300,6037574300,2023,1666,504,30.25,476,28
1400000US06037574400,6037574400,2023,3578,972,27.17,929,43
1400000US06037574500,6037574500,2023,793,257,32.41,235,22
1400000US06037574602,6037574602,2023,473,127,26.85,122,5
1400000US06037574901,6037574901,2023,640,145,22.66,135,10
1400000US06037575001,6037575001,2023,310,201,64.839996,196,5
1400000US06037575002,6037575002,2023,324,197,60.799999,189,8
1400000US06037575101,6037575101,2023,701,532,75.889999,522,10
1400000US06037575201,6037575201,2023,564,418,74.110001,413,5
1400000US06037575300,6037575300,2023,4668,2674,57.279999,2612,62
1400000US06037575401,6037575401,2023,1813,1297,71.540001,1287,10
1400000US06037575402,6037575402,2023,128,81,63.279999,79,2
1400000US06037575901,6037575901,2023,410,294,71.709999,290,4
1400000US06037576200,6037576200,2023,839,577,68.769997,568,9
1400000US06037576301,6037576301,2023,988,637,64.470001,625,12
1400000US06037576401,6037576401,2023,801,600,74.910004,587,13
1400000US06037576501,6037576501,2023,1095,832,75.980003,824,8
1400000US06037576801,6037576801,2023,559,413,73.879997,405,8
1400000US06037576903,6037576903,2023,558,399,71.510002,392,7
1400000US06037577000,6037577000,2023,4414,2369,53.669998,2336,33
1400000US06037577100,6037577100,2023,755,325,43.049999,313,12
1400000US06037577501,6037577501,2023,271,54,19.93,52,2
1400000US06037577602,6037577602,2023,313,86,27.48,82,4
1400000US06037577606,6037577606,2023,1325,338,25.51,330,8
1400000US06037577700,6037577700,2023,994,599,60.259998,573,26
1400000US06037577800,6037577800,2023,514,382,74.32,293,89
1400000US06037577900,6037577900,2023,471,284,60.299999,261,23
1400000US06037578000,6037578000,2023,2186,1480,67.699997,1446,34
1400000US06037599000,6037599000,2023,436,226,51.830002,213,13
1400000US06037600201,6037600201,2023,725,709,97.790001,697,12
1400000US06037600302,6037600302,2023,1840,1781,96.790001,1751,30
1400000US06037600303,6037600303,2023,568,562,98.940002,552,10
1400000US06037600501,6037600501,2023,262,252,96.18,243,9
1400000US06037600602,6037600602,2023,1114,875,78.550003,843,32
1400000US06037600702,6037600702,2023,309,274,88.669998,248,26
1400000US06037600703,6037600703,2023,596,552,92.620003,481,71
1400000US06037600911,6037600911,2023,531,455,85.690002,434,21
1400000US06037601001,6037601001,2023,70,69,98.57,66,3
1400000US06037601002,6037601002,2023,383,322,84.07,309,13
1400000US06037601202,6037601202,2023,1040,854,82.120003,787,67
1400000US06037601211,6037601211,2023,1440,1111,77.150002,1049,62
1400000US06037601212,6037601212,2023,364,349,95.879997,297,52
1400000US06037601301,6037601301,2023,593,418,70.489998,384,34
1400000US06037601303,6037601303,2023,996,679,68.169998,620,59
1400000US06037601401,6037601401,2023,370,301,81.349998,288,13
1400000US06037601402,6037601402,2023,477,386,80.919998,360,26
1400000US06037601502,6037601502,2023,1102,1003,91.019997,896,107
1400000US06037601600,6037601600,2023,1785,1645,92.160004,1465,180
1400000US06037601700,6037601700,2023,1880,1715,91.220001,1486,229
1400000US06037601802,6037601802,2023,508,471,92.720001,422,49
1400000US06037602003,6037602003,2023,393,353,89.82,321,32
1400000US06037602104,6037602104,2023,446,316,70.849998,280,36
1400000US06037602106,6037602106,2023,1229,729,59.32,671,58
1400000US06037602201,6037602201,2023,3572,2029,56.799999,1799,230
1400000US06037602302,6037602302,2023,1854,555,29.940001,481,74
1400000US06037602402,6037602402,2023,726,330,45.450001,308,22
1400000US06037602403,6037602403,2023,1167,762,65.300003,679,83
1400000US06037602404,6037602404,2023,509,316,62.080002,289,27
1400000US06037602505,6037602505,2023,759,477,62.849998,447,30
1400000US06037602506,6037602506,2023,678,428,63.130001,410,18
1400000US06037602511,6037602511,2023,1433,987,68.879997,931,56
1400000US06037602601,6037602601,2023,349,327,93.699997,317,10
1400000US06037602700,6037602700,2023,239,213,89.120003,203,10
1400000US06037602801,6037602801,2023,1044,1005,96.260002,924,81
1400000US06037602802,6037602802,2023,917,867,94.550003,819,48
1400000US06037603006,6037603006,2023,367,323,88.010002,309,14
1400000US06037603008,6037603008,2023,657,585,89.040001,547,38
1400000US06037603200,6037603200,2023,1512,1391,92,1323,68
1400000US06037603301,6037603301,2023,1777,1515,85.260002,1414,101
1400000US06037603400,6037603400,2023,693,469,67.68,412,57
1400000US06037603600,6037603600,2023,221,190,85.970001,171,19
1400000US06037603702,6037603702,2023,577,353,61.18,289,64
1400000US06037603705,6037603705,2023,101,72,71.290001,72,0
1400000US06037603706,6037603706,2023,458,406,88.650002,363,43
1400000US06037603801,6037603801,2023,1850,1364,73.730003,1297,67
1400000US06037603802,6037603802,2023,1388,1070,77.089996,946,124
1400000US06037603901,6037603901,2023,2814,2156,76.620003,1934,222
1400000US06037603902,6037603902,2023,740,576,77.839996,500,76
1400000US06037604001,6037604001,2023,487,377,77.410004,338,39
1400000US06037604002,6037604002,2023,550,467,84.910004,411,56
1400000US06037604200,6037604200,2023,771,663,85.989998,609,54
1400000US06037620001,6037620001,2023,739,71,9.6099997,68,3
1400000US06037620002,6037620002,2023,819,79,9.6499996,77,2
1400000US06037620101,6037620101,2023,1879,217,11.55,203,14
1400000US06037620303,6037620303,2023,519,8,1.54,8,0
1400000US06037620305,6037620305,2023,486,11,2.26,11,0
1400000US06037620400,6037620400,2023,1548,70,4.52,69,1
1400000US06037620501,6037620501,2023,592,87,14.7,81,6
1400000US06037620521,6037620521,2023,439,91,20.73,82,9
1400000US06037620602,6037620602,2023,1873,348,18.58,326,22
1400000US06037620701,6037620701,2023,437,51,11.67,44,7
1400000US06037620703,6037620703,2023,515,47,9.1300001,47,0
1400000US06037620802,6037620802,2023,2880,160,5.5599999,160,0
1400000US06037620904,6037620904,2023,275,13,4.73,13,0
1400000US06037621005,6037621005,2023,1239,92,7.4299998,85,7
1400000US06037621201,6037621201,2023,4455,697,15.65,655,42
1400000US06037621301,6037621301,2023,569,79,13.88,72,7
1400000US06037621400,6037621400,2023,408,61,14.95,57,4
1400000US06037650001,6037650001,2023,1019,353,34.639999,308,45
1400000US06037650004,6037650004,2023,371,174,46.900002,161,13
1400000US06037650101,6037650101,2023,513,155,30.209999,133,22
1400000US06037650200,6037650200,2023,2551,940,36.849998,825,115
1400000US06037650300,6037650300,2023,534,257,48.130001,242,15
1400000US06037650401,6037650401,2023,1108,268,24.190001,243,25
1400000US06037650502,6037650502,2023,1111,190,17.1,173,17
1400000US06037650603,6037650603,2023,2744,694,25.290001,626,68
1400000US06037650701,6037650701,2023,638,159,24.92,140,19
1400000US06037650702,6037650702,2023,567,59,10.41,53,6
1400000US06037650903,6037650903,2023,1978,603,30.49,534,69
1400000US06037650904,6037650904,2023,591,340,57.529999,308,32
1400000US06037651001,6037651001,2023,622,276,44.369999,253,23
1400000US06037651002,6037651002,2023,675,238,35.259998,212,26
1400000US06037651101,6037651101,2023,789,126,15.97,111,15
1400000US06037651201,6037651201,2023,510,65,12.75,60,5
1400000US06037651221,6037651221,2023,565,112,19.82,104,8
1400000US06037651222,6037651222,2023,2415,419,17.35,387,32
1400000US06037651302,6037651302,2023,1270,185,14.57,169,16
1400000US06037651402,6037651402,2023,607,92,15.16,83,9
1400000US06037670002,6037670002,2023,1085,946,87.190002,902,44
1400000US06037670003,6037670003,2023,846,581,68.68,536,45
1400000US06037670101,6037670101,2023,422,371,87.910004,355,16
1400000US06037670202,6037670202,2023,328,35,10.67,35,0
1400000US06037670324,6037670324,2023,641,44,6.8600001,40,4
1400000US06037670326,6037670326,2023,426,21,4.9299998,21,0
1400000US06037670328,6037670328,2023,2347,173,7.3699999,168,5
1400000US06037670405,6037670405,2023,890,85,9.5500002,85,0
1400000US06037670413,6037670413,2023,369,30,8.1300001,29,1
1400000US06037670416,6037670416,2023,343,45,13.12,44,1
1400000US06037670417,6037670417,2023,2663,250,9.3900003,249,1
1400000US06037670418,6037670418,2023,918,52,5.6599998,48,4
1400000US06037670500,6037670500,2023,98,20,20.41,20,0
1400000US06037670604,6037670604,2023,349,22,6.3000002,21,1
1400000US06037670701,6037670701,2023,1539,935,60.75,802,133
1400000US06037670702,6037670702,2023,747,66,8.8400002,63,3
1400000US06037700200,6037700200,2023,1823,959,52.610001,681,278
1400000US06037700400,6037700400,2023,248,165,66.529999,152,13
1400000US06037700501,6037700501,2023,291,88,30.24,83,5
1400000US06037700600,6037700600,2023,526,57,10.84,57,0
1400000US06037700901,6037700901,2023,534,97,18.16,95,2
1400000US06037700902,6037700902,2023,769,132,17.17,130,2
1400000US06037701000,6037701000,2023,1197,206,17.209999,200,6
1400000US06037701304,6037701304,2023,582,104,17.870001,101,3
1400000US06037701501,6037701501,2023,854,191,22.370001,177,14
1400000US06037701601,6037701601,2023,593,46,7.7600002,44,2
1400000US06037701602,6037701602,2023,388,132,34.02,118,14
1400000US06037701801,6037701801,2023,385,121,31.43,114,7
1400000US06037701902,6037701902,2023,2592,776,29.940001,709,67
1400000US06037702002,6037702002,2023,277,56,20.219999,56,0
1400000US06037702201,6037702201,2023,1364,509,37.32,471,38
1400000US06037702300,6037702300,2023,518,141,27.219999,122,19
1400000US06037702400,6037702400,2023,538,173,32.16,130,43
1400000US06037702600,6037702600,2023,1341,296,22.07,196,100
1400000US06037702700,6037702700,2023,4245,1708,40.240002,1276,432
1400000US06037702801,6037702801,2023,556,295,53.060001,249,46
1400000US06037702803,6037702803,2023,483,296,61.279999,274,22
1400000US06037703002,6037703002,2023,344,218,63.369999,211,7
1400000US06037703100,6037703100,2023,325,272,83.690002,267,5
1400000US06037703200,6037703200,2023,203,181,89.160004,180,1
1400000US06037800101,6037800101,2023,3056,638,20.879999,397,241
1400000US06037800103,6037800103,2023,215,33,15.35,33,0
1400000US06037800202,6037800202,2023,1071,239,22.32,163,76
1400000US06037800205,6037800205,2023,432,145,33.560001,109,36
1400000US06037800206,6037800206,2023,464,86,18.530001,50,36
1400000US06037800325,6037800325,2023,353,58,16.43,37,21
1400000US06037800334,6037800334,2023,2304,629,27.299999,391,238
1400000US06037800337,6037800337,2023,41,21,51.220001,18,3
1400000US06037800338,6037800338,2023,1712,433,25.290001,240,193
1400000US06037800411,6037800411,2023,634,90,14.2,88,2
1400000US06037800412,6037800412,2023,199,33,16.58,28,5
1400000US06037800504,6037800504,2023,209,22,10.53,22,0
1400000US06037900102,6037900102,2023,639,601,94.050003,559,42
1400000US06037900103,6037900103,2023,573,560,97.730003,527,33
1400000US06037900104,6037900104,2023,474,349,73.629997,330,19
1400000US06037900301,6037900301,2023,707,652,92.220001,614,38
1400000US06037900501,6037900501,2023,514,491,95.529999,450,41
1400000US06037900504,6037900504,2023,4352,3725,85.589996,3332,393
1400000US06037900505,6037900505,2023,678,643,94.839996,581,62
1400000US06037900508,6037900508,2023,2546,1549,60.84,1524,25
1400000US06037900510,6037900510,2023,1249,1120,89.669998,1041,79
1400000US06037900602,6037900602,2023,756,730,96.559998,690,40
1400000US06037900606,6037900606,2023,2686,2232,83.099998,2063,169
1400000US06037900607,6037900607,2023,738,705,95.529999,657,48
1400000US06037900609,6037900609,2023,672,633,94.199997,570,63
1400000US06037900610,6037900610,2023,648,573,88.43,502,71
1400000US06037900701,6037900701,2023,981,860,87.669998,797,63
1400000US06037900703,6037900703,2023,1494,1341,89.760002,1214,127
1400000US06037900804,6037900804,2023,709,676,95.349998,622,54
1400000US06037900805,6037900805,2023,788,714,90.610001,620,94
1400000US06037900806,6037900806,2023,2,0,0,0,0
1400000US06037900807,6037900807,2023,675,620,91.849998,550,70
1400000US06037900901,6037900901,2023,723,405,56.02,328,77
1400000US06037901007,6037901007,2023,689,475,68.940002,407,68
1400000US06037901009,6037901009,2023,973,879,90.339996,741,138
1400000US06037901010,6037901010,2023,695,573,82.449997,486,87
1400000US06037901011,6037901011,2023,680,578,85,491,87
1400000US06037901012,6037901012,2023,779,645,82.800003,526,119
1400000US06037901013,6037901013,2023,1273,820,64.410004,650,170
1400000US06037901014,6037901014,2023,2565,1510,58.869999,1426,84
1400000US06037901101,6037901101,2023,736,438,59.509998,355,83
1400000US06037901209,6037901209,2023,321,218,67.910004,195,23
1400000US06037901214,6037901214,2023,828,504,60.869999,408,96
1400000US06037901215,6037901215,2023,3613,1655,45.810001,1378,277
1400000US06037901217,6037901217,2023,251,155,61.75,128,27
1400000US06037901300,6037901300,2023,412,375,91.019997,353,22
1400000US06037910002,6037910002,2023,233,159,68.239998,142,17
1400000US06037910210,6037910210,2023,919,571,62.130001,457,114
1400000US06037910212,6037910212,2023,865,232,26.82,190,42
1400000US06037910214,6037910214,2023,4238,2740,64.650002,2436,304
1400000US06037910215,6037910215,2023,1561,1275,81.68,1095,180
1400000US06037910217,6037910217,2023,642,389,60.59,291,98
1400000US06037910218,6037910218,2023,570,448,78.599998,417,31
1400000US06037910301,6037910301,2023,786,546,69.470001,477,69
1400000US06037910302,6037910302,2023,1741,955,54.849998,762,193
1400000US06037910401,6037910401,2023,582,470,80.760002,405,65
1400000US06037910404,6037910404,2023,488,444,90.980003,406,38
1400000US06037910405,6037910405,2023,1251,1057,84.489998,964,93
1400000US06037910504,6037910504,2023,606,581,95.870003,551,30
1400000US06037910601,6037910601,2023,655,609,92.980003,570,39
1400000US06037910602,6037910602,2023,5416,3738,69.019997,3537,201
1400000US06037910605,6037910605,2023,1400,1238,88.43,1086,152
1400000US06037910606,6037910606,2023,553,488,88.25,460,28
1400000US06037910608,6037910608,2023,607,562,92.589996,517,45
1400000US06037910706,6037910706,2023,616,535,86.849998,452,83
1400000US06037910712,6037910712,2023,482,420,87.139999,370,50
1400000US06037910714,6037910714,2023,1254,1087,86.68,1002,85
1400000US06037910715,6037910715,2023,539,504,93.510002,460,44
1400000US06037910716,6037910716,2023,1556,1366,87.790001,1203,163
1400000US06037910717,6037910717,2023,4190,2709,64.650002,2418,291
1400000US06037910718,6037910718,2023,1378,1251,90.779999,1104,147
1400000US06037910720,6037910720,2023,622,556,89.389999,492,64
1400000US06037910804,6037910804,2023,3732,1714,45.93,1484,230
1400000US06037910807,6037910807,2023,1072,667,62.220001,532,135
1400000US06037910814,6037910814,2023,315,134,42.540001,123,11
1400000US06037910815,6037910815,2023,1238,803,64.860001,698,105
1400000US06037911001,6037911001,2023,905,718,79.339996,656,62
1400000US06037911100,6037911100,2023,2411,1621,67.230003,1543,78
1400000US06037920013,6037920013,2023,736,216,29.35,142,74
1400000US06037920015,6037920015,2023,901,255,28.299999,171,84
1400000US06037920017,6037920017,2023,1034,275,26.6,248,27
1400000US06037920020,6037920020,2023,621,245,39.450001,179,66
1400000US06037920029,6037920029,2023,2492,938,37.639999,808,130
1400000US06037920031,6037920031,2023,3019,1210,40.080002,1159,51
1400000US06037920034,6037920034,2023,956,629,65.790001,485,144
1400000US06037920035,6037920035,2023,504,408,80.949997,324,84
1400000US06037920041,6037920041,2023,1794,760,42.360001,631,129
1400000US06037920042,6037920042,2023,551,390,70.779999,320,70
1400000US06037920043,6037920043,2023,1382,568,41.099998,431,137
1400000US06037920044,6037920044,2023,2350,333,14.17,318,15
1400000US06037920048,6037920048,2023,1803,772,42.82,721,51
1400000US06037920049,6037920049,2023,780,136,17.440001,134,2
1400000US06037920102,6037920102,2023,707,373,52.759998,296,77
1400000US06037920104,6037920104,2023,1185,255,21.52,244,11
1400000US06037920109,6037920109,2023,444,48,10.81,46,2
1400000US06037920111,6037920111,2023,254,127,50,85,42
1400000US06037920112,6037920112,2023,1217,203,16.68,200,3
1400000US06037920115,6037920115,2023,1201,236,19.65,212,24
1400000US06037920118,6037920118,2023,1646,687,41.740002,550,137
1400000US06037920119,6037920119,2023,396,153,38.639999,88,65
1400000US06037920120,6037920120,2023,511,150,29.35,118,32
1400000US06037920121,6037920121,2023,4691,736,15.69,661,75
1400000US06037920313,6037920313,2023,832,539,64.779999,459,80
1400000US06037920314,6037920314,2023,715,263,36.779999,252,11
1400000US06037920322,6037920322,2023,475,219,46.110001,171,48
1400000US06037920326,6037920326,2023,808,240,29.700001,157,83
1400000US06037920329,6037920329,2023,885,332,37.509998,233,99
1400000US06037920330,6037920330,2023,395,49,12.41,48,1
1400000US06037920334,6037920334,2023,672,235,34.970001,150,85
1400000US06037920338,6037920338,2023,715,111,15.52,63,48
1400000US06037920339,6037920339,2023,3190,480,15.05,413,67
1400000US06037920340,6037920340,2023,2860,1230,43.009998,1195,35
1400000US06037920341,6037920341,2023,536,462,86.190002,430,32
1400000US06037920342,6037920342,2023,492,423,85.980003,372,51
1400000US06037930400,6037930400,2023,90,35,38.889999,34,1
1400000US06037980004,6037980004,2023,713,661,92.709999,636,25
1400000US06037980013,6037980013,2023,1172,546,46.59,442,104
1400000US06037980016,6037980016,2023,151,142,94.040001,139,3
1400000US06037980035,6037980035,2023,3,0,0,0,0
1400000US06037101110,6037101110,2022,1183,917,77.510002,782,135
1400000US06037101220,6037101220,2022,176,161,91.480003,154,7
1400000US06037101300,6037101300,2022,464,324,69.830002,271,53
1400000US06037102107,6037102107,2022,858,692,80.650002,583,109
1400000US06037103101,6037103101,2022,748,616,82.349998,558,58
1400000US06037103102,6037103102,2022,552,448,81.160004,417,31
1400000US06037103202,6037103202,2022,115,89,77.389999,81,8
1400000US06037103402,6037103402,2022,330,170,51.52,150,20
1400000US06037104103,6037104103,2022,554,487,87.910004,418,69
1400000US06037104105,6037104105,2022,792,689,86.989998,620,69
1400000US06037104108,6037104108,2022,1007,958,95.129997,925,33
1400000US06037104124,6037104124,2022,1118,997,89.18,863,134
1400000US06037104204,6037104204,2022,356,348,97.75,341,7
1400000US06037104310,6037104310,2022,2977,2899,97.379997,2557,342
1400000US06037104321,6037104321,2022,969,783,80.800003,739,44
1400000US06037104401,6037104401,2022,537,509,94.790001,492,17
1400000US06037104500,6037104500,2022,641,593,92.510002,554,39
1400000US06037104821,6037104821,2022,795,657,82.639999,579,78
1400000US06037104822,6037104822,2022,904,836,92.480003,795,41
1400000US06037106020,6037106020,2022,196,133,67.860001,127,6
1400000US06037106112,6037106112,2022,525,453,86.290001,413,40
1400000US06037106113,6037106113,2022,354,208,58.759998,187,21
1400000US06037106114,6037106114,2022,371,308,83.019997,275,33
1400000US06037106403,6037106403,2022,2085,1877,90.019997,1740,137
1400000US06037106405,6037106405,2022,2173,1925,88.589996,1800,125
1400000US06037106510,6037106510,2022,83,83,100,83,0
1400000US06037106520,6037106520,2022,1564,1422,90.919998,1251,171
1400000US06037106603,6037106603,2022,388,182,46.91,134,48
1400000US06037106604,6037106604,2022,316,291,92.089996,277,14
1400000US06037106641,6037106641,2022,1329,732,55.080002,589,143
1400000US06037106642,6037106642,2022,407,125,30.709999,104,21
1400000US06037106646,6037106646,2022,2654,1833,69.07,1497,336
1400000US06037106648,6037106648,2022,308,273,88.639999,256,17
1400000US06037107020,6037107020,2022,545,501,91.93,478,23
1400000US06037108104,6037108104,2022,593,123,20.74,106,17
1400000US06037108202,6037108202,2022,1279,250,19.549999,224,26
1400000US06037109200,6037109200,2022,250,178,71.199997,155,23
1400000US06037109300,6037109300,2022,508,354,69.690002,293,61
1400000US06037109500,6037109500,2022,1955,1816,92.889999,1712,104
1400000US06037109601,6037109601,2022,571,356,62.349998,317,39
1400000US06037109700,6037109700,2022,1043,685,65.68,554,131
1400000US06037109800,6037109800,2022,720,426,59.169998,345,81
1400000US06037111100,6037111100,2022,379,283,74.669998,240,43
1400000US06037111202,6037111202,2022,362,220,60.77,209,11
1400000US06037111204,6037111204,2022,2617,1109,42.380001,916,193
1400000US06037111206,6037111206,2022,388,198,51.029999,160,38
1400000US06037111302,6037111302,2022,393,248,63.099998,227,21
1400000US06037111303,6037111303,2022,1913,1269,66.339996,1072,197
1400000US06037111304,6037111304,2022,5591,2321,41.509998,1882,439
1400000US06037111401,6037111401,2022,435,293,67.360001,253,40
1400000US06037113101,6037113101,2022,470,263,55.959999,239,24
1400000US06037113212,6037113212,2022,376,198,52.66,179,19
1400000US06037113232,6037113232,2022,290,249,85.860001,239,10
1400000US06037113303,6037113303,2022,496,316,63.709999,281,35
1400000US06037113322,6037113322,2022,410,96,23.41,85,11
1400000US06037113323,6037113323,2022,1120,658,58.75,612,46
1400000US06037113324,6037113324,2022,1675,1080,64.480003,955,125
1400000US06037113423,6037113423,2022,101,80,79.209999,74,6
1400000US06037113428,6037113428,2022,652,608,93.25,585,23
1400000US06037115101,6037115101,2022,2136,1136,53.18,990,146
1400000US06037115103,6037115103,2022,915,663,72.459999,580,83
1400000US06037115202,6037115202,2022,446,289,64.800003,247,42
1400000US06037115301,6037115301,2022,504,184,36.509998,157,27
1400000US06037115302,6037115302,2022,390,361,92.559998,353,8
1400000US06037115401,6037115401,2022,717,676,94.279999,638,38
1400000US06037115403,6037115403,2022,276,212,76.809998,187,25
1400000US06037115404,6037115404,2022,254,56,22.049999,54,2
1400000US06037117101,6037117101,2022,2641,2525,95.610001,2383,142
1400000US06037117102,6037117102,2022,374,335,89.57,316,19
1400000US06037117202,6037117202,2022,2139,1970,92.099998,1885,85
1400000US06037117302,6037117302,2022,417,386,92.57,365,21
1400000US06037117303,6037117303,2022,287,105,36.59,97,8
1400000US06037117407,6037117407,2022,516,511,99.029999,502,9
1400000US06037117510,6037117510,2022,511,485,94.910004,409,76
1400000US06037117520,6037117520,2022,553,543,98.190002,532,11
1400000US06037117530,6037117530,2022,692,672,97.110001,655,17
1400000US06037119003,6037119003,2022,446,418,93.720001,404,14
1400000US06037119004,6037119004,2022,446,384,86.099998,341,43
1400000US06037119201,6037119201,2022,1461,1344,91.989998,1263,81
1400000US06037119342,6037119342,2022,491,451,91.849998,432,19
1400000US06037119802,6037119802,2022,573,505,88.129997,471,34
1400000US06037119900,6037119900,2022,786,721,91.730003,635,86
1400000US06037120010,6037120010,2022,1202,1183,98.419998,1160,23
1400000US06037120020,6037120020,2022,550,536,97.449997,524,12
1400000US06037120030,6037120030,2022,1560,1497,95.959999,1450,47
1400000US06037120107,6037120107,2022,452,443,98.010002,434,9
1400000US06037120108,6037120108,2022,810,786,97.040001,772,14
1400000US06037120300,6037120300,2022,259,246,94.980003,237,9
1400000US06037120400,6037120400,2022,402,363,90.300003,345,18
1400000US06037121010,6037121010,2022,3436,3224,93.830002,3007,217
1400000US06037121020,6037121020,2022,440,408,92.730003,377,31
1400000US06037121102,6037121102,2022,253,193,76.279999,165,28
1400000US06037121210,6037121210,2022,344,274,79.650002,232,42
1400000US06037121222,6037121222,2022,2482,2208,88.959999,2021,187
1400000US06037121600,6037121600,2022,40,28,70,26,2
1400000US06037121801,6037121801,2022,305,293,96.07,281,12
1400000US06037121900,6037121900,2022,347,325,93.660004,306,19
1400000US06037122000,6037122000,2022,481,443,92.099998,418,25
1400000US06037122122,6037122122,2022,483,456,94.410004,431,25
1400000US06037122200,6037122200,2022,194,181,93.300003,172,9
1400000US06037122420,6037122420,2022,440,415,94.32,397,18
1400000US06037123010,6037123010,2022,1542,1357,88,1307,50
1400000US06037123301,6037123301,2022,370,360,97.300003,348,12
1400000US06037123303,6037123303,2022,561,529,94.300003,506,23
1400000US06037123420,6037123420,2022,1429,1326,92.790001,1280,46
1400000US06037123510,6037123510,2022,653,601,92.040001,586,15
1400000US06037123601,6037123601,2022,1828,1672,91.470001,1578,94
1400000US06037123602,6037123602,2022,559,517,92.489998,486,31
1400000US06037123700,6037123700,2022,629,457,72.660004,401,56
1400000US06037123901,6037123901,2022,1619,1408,86.970001,1345,63
1400000US06037124102,6037124102,2022,625,573,91.68,533,40
1400000US06037124201,6037124201,2022,599,573,95.660004,547,26
1400000US06037124300,6037124300,2022,277,260,93.860001,250,10
1400000US06037124600,6037124600,2022,1426,709,49.720001,629,80
1400000US06037124700,6037124700,2022,389,130,33.419998,118,12
1400000US06037124902,6037124902,2022,301,227,75.419998,204,23
1400000US06037125101,6037125101,2022,2699,1636,60.619999,1472,164
1400000US06037125102,6037125102,2022,604,153,25.33,134,19
1400000US06037125310,6037125310,2022,902,579,64.190002,551,28
1400000US06037125322,6037125322,2022,313,275,87.860001,272,3
1400000US06037125600,6037125600,2022,434,285,65.669998,248,37
1400000US06037127210,6037127210,2022,2383,2125,89.169998,2034,91
1400000US06037127400,6037127400,2022,407,379,93.120003,368,11
1400000US06037127603,6037127603,2022,530,514,96.980003,492,22
1400000US06037127803,6037127803,2022,245,164,66.940002,144,20
1400000US06037127805,6037127805,2022,382,367,96.07,354,13
1400000US06037127806,6037127806,2022,2394,2034,84.959999,1908,126
1400000US06037127910,6037127910,2022,880,631,71.699997,591,40
1400000US06037127920,6037127920,2022,582,547,93.989998,522,25
1400000US06037128102,6037128102,2022,729,653,89.57,608,45
1400000US06037128302,6037128302,2022,639,619,96.870003,604,15
1400000US06037128602,6037128602,2022,386,197,51.040001,174,23
1400000US06037128802,6037128802,2022,1934,1285,66.440002,1194,91
1400000US06037128910,6037128910,2022,163,82,50.310001,81,1
1400000US06037131022,6037131022,2022,294,275,93.540001,265,10
1400000US06037131023,6037131023,2022,385,338,87.790001,319,19
1400000US06037131100,6037131100,2022,395,252,63.799999,238,14
1400000US06037131200,6037131200,2022,332,224,67.470001,186,38
1400000US06037131300,6037131300,2022,340,331,97.349998,324,7
1400000US06037131600,6037131600,2022,3040,1982,65.199997,1790,192
1400000US06037131701,6037131701,2022,41,23,56.099998,21,2
1400000US06037131801,6037131801,2022,1036,880,84.940002,803,77
1400000US06037131900,6037131900,2022,272,242,88.970001,222,20
1400000US06037132001,6037132001,2022,325,256,78.769997,233,23
1400000US06037132002,6037132002,2022,6024,4872,80.879997,4370,502
1400000US06037132301,6037132301,2022,284,254,89.440002,239,15
1400000US06037132501,6037132501,2022,6,6,100,5,1
1400000US06037132700,6037132700,2022,1907,1692,88.730003,1604,88
1400000US06037133000,6037133000,2022,505,343,67.919998,304,39
1400000US06037133101,6037133101,2022,395,352,89.110001,339,13
1400000US06037133102,6037133102,2022,1893,987,52.139999,809,178
1400000US06037134001,6037134001,2022,614,592,96.419998,580,12
1400000US06037134002,6037134002,2022,437,244,55.84,220,24
1400000US06037134101,6037134101,2022,322,294,91.300003,283,11
1400000US06037134103,6037134103,2022,441,409,92.739998,398,11
1400000US06037134104,6037134104,2022,415,376,90.599998,342,34
1400000US06037134302,6037134302,2022,386,283,73.32,258,25
1400000US06037134303,6037134303,2022,498,479,96.18,462,17
1400000US06037134304,6037134304,2022,991,916,92.43,856,60
1400000US06037134421,6037134421,2022,541,128,23.66,121,7
1400000US06037134422,6037134422,2022,204,135,66.18,115,20
1400000US06037134423,6037134423,2022,351,131,37.32,115,16
1400000US06037134520,6037134520,2022,1461,1319,90.279999,1271,48
1400000US06037134522,6037134522,2022,643,564,87.709999,518,46
1400000US06037134720,6037134720,2022,1471,1334,90.690002,1243,91
1400000US06037134801,6037134801,2022,357,332,93,316,16
1400000US06037135102,6037135102,2022,264,138,52.27,126,12
1400000US06037135202,6037135202,2022,729,135,18.52,124,11
1400000US06037135204,6037135204,2022,794,220,27.709999,204,16
1400000US06037137000,6037137000,2022,3560,1128,31.690001,1024,104
1400000US06037137104,6037137104,2022,578,470,81.309998,449,21
1400000US06037137203,6037137203,2022,636,443,69.650002,421,22
1400000US06037137301,6037137301,2022,511,176,34.439999,166,10
1400000US06037137302,6037137302,2022,1976,711,35.98,623,88
1400000US06037137401,6037137401,2022,601,140,23.290001,129,11
1400000US06037137402,6037137402,2022,397,104,26.200001,87,17
1400000US06037137501,6037137501,2022,2741,1382,50.419998,1188,194
1400000US06037139001,6037139001,2022,290,101,34.830002,82,19
1400000US06037139200,6037139200,2022,245,141,57.549999,123,18
1400000US06037139301,6037139301,2022,542,383,70.660004,344,39
1400000US06037139402,6037139402,2022,2798,1070,38.240002,971,99
1400000US06037139502,6037139502,2022,375,206,54.93,193,13
1400000US06037139600,6037139600,2022,521,156,29.940001,133,23
1400000US06037139701,6037139701,2022,490,39,7.96,35,4
1400000US06037141101,6037141101,2022,610,157,25.74,149,8
1400000US06037141304,6037141304,2022,522,155,29.690001,148,7
1400000US06037141400,6037141400,2022,478,82,17.15,73,9
1400000US06037143200,6037143200,2022,752,412,54.790001,376,36
1400000US06037143302,6037143302,2022,1469,739,50.310001,683,56
1400000US06037143700,6037143700,2022,159,43,27.040001,39,4
1400000US06037143801,6037143801,2022,825,105,12.73,101,4
1400000US06037181000,6037181000,2022,400,362,90.5,327,35
1400000US06037181400,6037181400,2022,717,286,39.889999,229,57
1400000US06037181500,6037181500,2022,752,286,38.029999,259,27
1400000US06037181600,6037181600,2022,2118,1052,49.669998,881,171
1400000US06037183101,6037183101,2022,1233,1058,85.809998,989,69
1400000US06037183104,6037183104,2022,230,157,68.260002,141,16
1400000US06037183220,6037183220,2022,194,165,85.050003,156,9
1400000US06037183401,6037183401,2022,252,202,80.160004,183,19
1400000US06037183402,6037183402,2022,229,195,85.150002,182,13
1400000US06037183510,6037183510,2022,1401,1238,88.370003,1148,90
1400000US06037183520,6037183520,2022,261,242,92.720001,229,13
1400000US06037183702,6037183702,2022,152,130,85.529999,119,11
1400000US06037183810,6037183810,2022,355,306,86.199997,288,18
1400000US06037185101,6037185101,2022,431,341,79.120003,318,23
1400000US06037185102,6037185102,2022,361,269,74.519997,252,17
1400000US06037185204,6037185204,2022,407,60,14.74,57,3
1400000US06037185310,6037185310,2022,1006,921,91.550003,869,52
1400000US06037186100,6037186100,2022,436,209,47.939999,170,39
1400000US06037186401,6037186401,2022,1574,1217,77.32,1148,69
1400000US06037186404,6037186404,2022,248,220,88.709999,208,12
1400000US06037187101,6037187101,2022,278,153,55.040001,143,10
1400000US06037187102,6037187102,2022,1344,773,57.509998,664,109
1400000US06037187300,6037187300,2022,272,209,76.839996,177,32
1400000US06037188201,6037188201,2022,407,45,11.06,37,8
1400000US06037188300,6037188300,2022,183,111,60.66,96,15
1400000US06037189201,6037189201,2022,354,307,86.720001,286,21
1400000US06037189501,6037189501,2022,214,157,73.360001,145,12
1400000US06037189905,6037189905,2022,294,149,50.68,134,15
1400000US06037190102,6037190102,2022,1178,1085,92.110001,1060,25
1400000US06037190510,6037190510,2022,370,353,95.410004,341,12
1400000US06037190901,6037190901,2022,1233,1189,96.43,1133,56
1400000US06037190902,6037190902,2022,769,727,94.540001,701,26
1400000US06037191120,6037191120,2022,303,290,95.709999,283,7
1400000US06037191204,6037191204,2022,310,296,95.480003,288,8
1400000US06037191301,6037191301,2022,78,66,84.620003,63,3
1400000US06037191410,6037191410,2022,346,335,96.82,321,14
1400000US06037191720,6037191720,2022,769,734,95.449997,684,50
1400000US06037191810,6037191810,2022,282,266,94.330002,258,8
1400000US06037191901,6037191901,2022,501,460,91.82,438,22
1400000US06037192001,6037192001,2022,420,171,40.709999,139,32
1400000US06037192002,6037192002,2022,1672,1201,71.830002,1103,98
1400000US06037192410,6037192410,2022,170,148,87.059998,136,12
1400000US06037192520,6037192520,2022,256,239,93.360001,235,4
1400000US06037192620,6037192620,2022,498,473,94.980003,456,17
1400000US06037192700,6037192700,2022,252,237,94.050003,228,9
1400000US06037194300,6037194300,2022,424,84,19.809999,83,1
1400000US06037195201,6037195201,2022,2354,1416,60.150002,1228,188
1400000US06037195300,6037195300,2022,1826,1173,64.239998,1070,103
1400000US06037195400,6037195400,2022,335,128,38.209999,123,5
1400000US06037195500,6037195500,2022,142,126,88.730003,116,10
1400000US06037195710,6037195710,2022,795,731,91.949997,701,30
1400000US06037197200,6037197200,2022,224,169,75.449997,153,16
1400000US06037197300,6037197300,2022,344,206,59.880001,192,14
1400000US06037197410,6037197410,2022,107,66,61.68,63,3
1400000US06037197420,6037197420,2022,812,603,74.260002,577,26
1400000US06037199001,6037199001,2022,168,36,21.43,34,2
1400000US06037199002,6037199002,2022,245,230,93.879997,221,9
1400000US06037199120,6037199120,2022,370,333,90,291,42
1400000US06037199201,6037199201,2022,307,232,75.57,222,10
1400000US06037199202,6037199202,2022,1208,1152,95.360001,1101,51
1400000US06037199300,6037199300,2022,558,453,81.18,430,23
1400000US06037199400,6037199400,2022,90,85,94.440002,83,2
1400000US06037199700,6037199700,2022,1086,982,90.419998,920,62
1400000US06037199801,6037199801,2022,317,298,94.010002,283,15
1400000US06037199802,6037199802,2022,469,436,92.959999,416,20
1400000US06037201120,6037201120,2022,160,144,90,133,11
1400000US06037201200,6037201200,2022,265,250,94.339996,240,10
1400000US06037201301,6037201301,2022,238,223,93.699997,213,10
1400000US06037201302,6037201302,2022,39,20,51.279999,20,0
1400000US06037201401,6037201401,2022,1471,1296,88.099998,1210,86
1400000US06037201402,6037201402,2022,1606,1460,90.910004,1383,77
1400000US06037201501,6037201501,2022,185,176,95.139999,175,1
1400000US06037201602,6037201602,2022,272,252,92.650002,231,21
1400000US06037201700,6037201700,2022,517,85,16.440001,85,0
1400000US06037203100,6037203100,2022,361,348,96.400002,339,9
1400000US06037203200,6037203200,2022,530,507,95.660004,490,17
1400000US06037203300,6037203300,2022,1806,1591,88.099998,1471,120
1400000US06037203500,6037203500,2022,160,157,98.129997,149,8
1400000US06037203601,6037203601,2022,504,489,97.019997,481,8
1400000US06037203800,6037203800,2022,422,398,94.309998,391,7
1400000US06037204110,6037204110,2022,502,423,84.260002,372,51
1400000US06037204300,6037204300,2022,2494,2401,96.269997,2330,71
1400000US06037204410,6037204410,2022,210,190,90.480003,186,4
1400000US06037204420,6037204420,2022,659,624,94.690002,610,14
1400000US06037204700,6037204700,2022,2090,1987,95.07,1847,140
1400000US06037204810,6037204810,2022,1281,1182,92.269997,1142,40
1400000US06037204820,6037204820,2022,599,571,95.330002,525,46
1400000US06037204910,6037204910,2022,1104,1060,96.010002,1018,42
1400000US06037205110,6037205110,2022,918,876,95.419998,811,65
1400000US06037205120,6037205120,2022,70,67,95.709999,66,1
1400000US06037206010,6037206010,2022,258,176,68.220001,160,16
1400000US06037206050,6037206050,2022,228,172,75.440002,154,18
1400000US06037206051,6037206051,2022,326,289,88.650002,262,27
1400000US06037206054,6037206054,2022,1190,1141,95.879997,1093,48
1400000US06037207101,6037207101,2022,1118,685,61.27,644,41
1400000US06037207103,6037207103,2022,578,477,82.529999,458,19
1400000US06037207400,6037207400,2022,280,206,73.57,197,9
1400000US06037207502,6037207502,2022,458,375,81.879997,344,31
1400000US06037207712,6037207712,2022,233,117,50.209999,117,0
1400000US06037208001,6037208001,2022,2476,2275,91.879997,2163,112
1400000US06037208002,6037208002,2022,437,415,94.970001,387,28
1400000US06037208302,6037208302,2022,1291,1222,94.660004,1187,35
1400000US06037208401,6037208401,2022,831,823,99.040001,811,12
1400000US06037208501,6037208501,2022,890,526,59.099998,448,78
1400000US06037208610,6037208610,2022,408,377,92.400002,353,24
1400000US06037208710,6037208710,2022,56,55,98.209999,52,3
1400000US06037208720,6037208720,2022,542,482,88.93,410,72
1400000US06037208801,6037208801,2022,412,408,99.029999,407,1
1400000US06037208802,6037208802,2022,672,631,93.900002,597,34
1400000US06037208902,6037208902,2022,1194,1097,91.879997,1093,4
1400000US06037209103,6037209103,2022,557,522,93.720001,507,15
1400000US06037209104,6037209104,2022,398,396,99.5,396,0
1400000US06037209106,6037209106,2022,869,866,99.650002,861,5
1400000US06037209202,6037209202,2022,1166,1149,98.540001,1137,12
1400000US06037209520,6037209520,2022,601,557,92.68,511,46
1400000US06037209820,6037209820,2022,465,383,82.370003,372,11
1400000US06037210010,6037210010,2022,475,464,97.68,455,9
1400000US06037211000,6037211000,2022,1457,1214,83.32,1157,57
1400000US06037211121,6037211121,2022,934,861,92.18,829,32
1400000US06037211122,6037211122,2022,2063,1936,93.839996,1860,76
1400000US06037211123,6037211123,2022,943,909,96.389999,883,26
1400000US06037211124,6037211124,2022,677,583,86.120003,545,38
1400000US06037211202,6037211202,2022,515,497,96.5,486,11
1400000US06037211410,6037211410,2022,484,454,93.800003,431,23
1400000US06037211420,6037211420,2022,338,299,88.459999,285,14
1400000US06037212202,6037212202,2022,543,534,98.339996,524,10
1400000US06037212204,6037212204,2022,733,671,91.540001,609,62
1400000US06037212303,6037212303,2022,254,221,87.010002,205,16
1400000US06037212304,6037212304,2022,3592,3432,95.550003,3328,104
1400000US06037212610,6037212610,2022,645,587,91.010002,558,29
1400000US06037212800,6037212800,2022,1993,1475,74.010002,1401,74
1400000US06037213201,6037213201,2022,501,445,88.82,436,9
1400000US06037213202,6037213202,2022,455,447,98.239998,439,8
1400000US06037213310,6037213310,2022,105,102,97.139999,99,3
1400000US06037213320,6037213320,2022,903,873,96.68,841,32
1400000US06037213402,6037213402,2022,582,574,98.629997,564,10
1400000US06037214100,6037214100,2022,591,161,27.24,154,7
1400000US06037214501,6037214501,2022,520,175,33.650002,166,9
1400000US06037216201,6037216201,2022,88,75,85.230003,71,4
1400000US06037216301,6037216301,2022,279,156,55.91,144,12
1400000US06037216700,6037216700,2022,1712,959,56.02,807,152
1400000US06037217101,6037217101,2022,240,226,94.169998,216,10
1400000US06037218110,6037218110,2022,1625,1190,73.230003,1125,65
1400000US06037218210,6037218210,2022,364,356,97.800003,343,13
1400000US06037218300,6037218300,2022,320,292,91.25,266,26
1400000US06037218800,6037218800,2022,403,387,96.029999,376,11
1400000US06037218900,6037218900,2022,707,615,86.989998,565,50
1400000US06037219010,6037219010,2022,355,341,96.059998,325,16
1400000US06037219300,6037219300,2022,522,337,64.559998,335,2
1400000US06037219700,6037219700,2022,718,646,89.970001,632,14
1400000US06037219800,6037219800,2022,569,536,94.199997,497,39
1400000US06037219902,6037219902,2022,575,531,92.349998,509,22
1400000US06037220000,6037220000,2022,179,169,94.410004,168,1
1400000US06037220100,6037220100,2022,847,616,72.730003,576,40
1400000US06037221120,6037221120,2022,592,591,99.830002,574,17
1400000US06037221304,6037221304,2022,433,422,97.459999,412,10
1400000US06037221401,6037221401,2022,937,894,95.410004,857,37
1400000US06037221602,6037221602,2022,1813,1728,95.309998,1695,33
1400000US06037221810,6037221810,2022,370,351,94.860001,342,9
1400000US06037221900,6037221900,2022,282,273,96.809998,268,5
1400000US06037222002,6037222002,2022,394,361,91.620003,354,7
1400000US06037222500,6037222500,2022,1721,1597,92.790001,1542,55
1400000US06037222600,6037222600,2022,723,662,91.559998,631,31
1400000US06037224010,6037224010,2022,14,14,100,14,0
1400000US06037224020,6037224020,2022,1568,1445,92.160004,1382,63
1400000US06037224320,6037224320,2022,453,416,91.830002,376,40
1400000US06037224410,6037224410,2022,1748,1609,92.050003,1551,58
1400000US06037224420,6037224420,2022,812,458,56.400002,458,0
1400000US06037224600,6037224600,2022,1054,1015,96.300003,989,26
1400000US06037224702,6037224702,2022,902,808,89.580002,745,63
1400000US06037226001,6037226001,2022,2607,2543,97.550003,2495,48
1400000US06037226002,6037226002,2022,721,663,91.959999,646,17
1400000US06037226702,6037226702,2022,1092,1068,97.800003,1034,34
1400000US06037227020,6037227020,2022,1057,1048,99.150002,1024,24
1400000US06037228100,6037228100,2022,1575,1544,98.029999,1474,70
1400000US06037228210,6037228210,2022,1543,1504,97.470001,1480,24
1400000US06037228310,6037228310,2022,1061,1037,97.739998,1021,16
1400000US06037228320,6037228320,2022,486,477,98.150002,471,6
1400000US06037228410,6037228410,2022,665,589,88.57,556,33
1400000US06037228420,6037228420,2022,1241,1191,95.970001,1151,40
1400000US06037228500,6037228500,2022,579,526,90.849998,512,14
1400000US06037228600,6037228600,2022,1092,1073,98.260002,1062,11
1400000US06037228710,6037228710,2022,1477,1256,85.040001,1244,12
1400000US06037228720,6037228720,2022,663,649,97.889999,631,18
1400000US06037228800,6037228800,2022,175,173,98.860001,172,1
1400000US06037229200,6037229200,2022,534,523,97.940002,514,9
1400000US06037229300,6037229300,2022,498,455,91.370003,428,27
1400000US06037229410,6037229410,2022,2678,2640,98.580002,2577,63
1400000US06037229420,6037229420,2022,1352,1326,98.080002,1302,24
1400000US06037231100,6037231100,2022,1688,1639,97.099998,1579,60
1400000US06037231220,6037231220,2022,1083,848,78.300003,783,65
1400000US06037231302,6037231302,2022,318,313,98.43,305,8
1400000US06037231400,6037231400,2022,104,83,79.809998,83,0
1400000US06037231500,6037231500,2022,388,353,90.980003,318,35
1400000US06037231603,6037231603,2022,967,941,97.309998,913,28
1400000US06037231710,6037231710,2022,425,417,98.120003,413,4
1400000US06037231720,6037231720,2022,327,229,70.029999,222,7
1400000US06037231800,6037231800,2022,539,532,98.699997,522,10
1400000US06037232110,6037232110,2022,1018,1003,98.529999,991,12
1400000US06037232200,6037232200,2022,1192,1132,94.970001,1062,70
1400000US06037232300,6037232300,2022,267,260,97.379997,236,24
1400000US06037232401,6037232401,2022,814,755,92.75,735,20
1400000US06037232500,6037232500,2022,486,454,93.419998,445,9
1400000US06037234001,6037234001,2022,630,606,96.190002,552,54
1400000US06037234002,6037234002,2022,398,397,99.75,378,19
1400000US06037234301,6037234301,2022,602,572,95.019997,556,16
1400000US06037234501,6037234501,2022,712,670,94.099998,655,15
1400000US06037234502,6037234502,2022,532,514,96.620003,475,39
1400000US06037234600,6037234600,2022,2089,1906,91.239998,1720,186
1400000US06037234700,6037234700,2022,213,200,93.900002,191,9
1400000US06037234901,6037234901,2022,430,415,96.510002,411,4
1400000US06037234902,6037234902,2022,208,188,90.379997,179,9
1400000US06037235201,6037235201,2022,1023,935,91.400002,890,45
1400000US06037236203,6037236203,2022,598,574,95.989998,520,54
1400000US06037236204,6037236204,2022,441,433,98.190002,429,4
1400000US06037236400,6037236400,2022,135,131,97.040001,131,0
1400000US06037237101,6037237101,2022,2301,2238,97.260002,2200,38
1400000US06037237102,6037237102,2022,528,514,97.349998,508,6
1400000US06037237300,6037237300,2022,594,569,95.790001,555,14
1400000US06037237500,6037237500,2022,464,450,96.980003,444,6
1400000US06037237600,6037237600,2022,514,502,97.669998,498,4
1400000US06037237800,6037237800,2022,371,357,96.230003,345,12
1400000US06037237900,6037237900,2022,304,277,91.120003,263,14
1400000US06037238000,6037238000,2022,609,587,96.389999,584,3
1400000US06037238100,6037238100,2022,256,250,97.660004,250,0
1400000US06037238200,6037238200,2022,663,552,83.260002,541,11
1400000US06037238320,6037238320,2022,1063,992,93.32,911,81
1400000US06037238400,6037238400,2022,299,294,98.330002,289,5
1400000US06037239201,6037239201,2022,1011,977,96.639999,962,15
1400000US06037239320,6037239320,2022,873,856,98.050003,842,14
1400000US06037239330,6037239330,2022,706,687,97.309998,671,16
1400000US06037239502,6037239502,2022,3080,3020,98.050003,2972,48
1400000US06037239601,6037239601,2022,802,778,97.010002,769,9
1400000US06037239802,6037239802,2022,841,815,96.910004,799,16
1400000US06037240010,6037240010,2022,1048,1017,97.040001,988,29
1400000US06037240020,6037240020,2022,429,399,93.010002,365,34
1400000US06037240200,6037240200,2022,620,604,97.419998,595,9
1400000US06037240301,6037240301,2022,606,594,98.019997,587,7
1400000US06037240302,6037240302,2022,100,97,97,95,2
1400000US06037240401,6037240401,2022,934,912,97.639999,883,29
1400000US06037240500,6037240500,2022,1427,1350,94.599998,1286,64
1400000US06037240600,6037240600,2022,863,848,98.260002,838,10
1400000US06037240700,6037240700,2022,462,450,97.400002,438,12
1400000US06037240902,6037240902,2022,1931,1882,97.459999,1814,68
1400000US06037241001,6037241001,2022,766,729,95.169998,694,35
1400000US06037241110,6037241110,2022,937,917,97.870003,894,23
1400000US06037241120,6037241120,2022,431,429,99.540001,421,8
1400000US06037241202,6037241202,2022,518,507,97.879997,497,10
1400000US06037241400,6037241400,2022,437,429,98.169998,421,8
1400000US06037242000,6037242000,2022,260,260,100,252,8
1400000US06037242100,6037242100,2022,738,729,98.779999,719,10
1400000US06037242201,6037242201,2022,648,639,98.610001,626,13
1400000US06037242202,6037242202,2022,663,646,97.440002,630,16
1400000US06037242300,6037242300,2022,558,551,98.75,543,8
1400000US06037242600,6037242600,2022,512,506,98.830002,496,10
1400000US06037242700,6037242700,2022,951,936,98.419998,925,11
1400000US06037243001,6037243001,2022,489,420,85.889999,409,11
1400000US06037243002,6037243002,2022,321,317,98.75,311,6
1400000US06037243100,6037243100,2022,372,364,97.849998,360,4
1400000US06037262200,6037262200,2022,780,149,19.1,134,15
1400000US06037262303,6037262303,2022,453,44,9.71,42,2
1400000US06037262604,6037262604,2022,323,48,14.86,44,4
1400000US06037262704,6037262704,2022,2901,801,27.610001,722,79
1400000US06037262706,6037262706,2022,402,44,10.95,40,4
1400000US06037262802,6037262802,2022,2110,460,21.799999,426,34
1400000US06037264305,6037264305,2022,307,263,85.669998,251,12
1400000US06037265100,6037265100,2022,534,48,8.9899998,43,5
1400000US06037265601,6037265601,2022,841,297,35.32,273,24
1400000US06037267202,6037267202,2022,625,78,12.48,67,11
1400000US06037267300,6037267300,2022,193,157,81.349998,144,13
1400000US06037267404,6037267404,2022,1424,970,68.120003,833,137
1400000US06037267406,6037267406,2022,181,134,74.029999,124,10
1400000US06037267600,6037267600,2022,1023,183,17.889999,164,19
1400000US06037269000,6037269000,2022,477,153,32.080002,138,15
1400000US06037269100,6037269100,2022,327,112,34.25,101,11
1400000US06037269300,6037269300,2022,420,44,10.48,42,2
1400000US06037269700,6037269700,2022,2652,1894,71.419998,1706,188
1400000US06037269907,6037269907,2022,248,181,72.980003,167,14
1400000US06037271200,6037271200,2022,542,276,50.919998,228,48
1400000US06037271300,6037271300,2022,775,499,64.389999,481,18
1400000US06037271400,6037271400,2022,223,79,35.43,73,6
1400000US06037271500,6037271500,2022,514,53,10.31,47,6
1400000US06037271702,6037271702,2022,397,112,28.209999,101,11
1400000US06037271703,6037271703,2022,1265,750,59.290001,664,86
1400000US06037271801,6037271801,2022,231,182,78.790001,169,13
1400000US06037272100,6037272100,2022,1165,627,53.82,570,57
1400000US06037272302,6037272302,2022,10,5,50,5,0
1400000US06037273200,6037273200,2022,973,541,55.599998,499,42
1400000US06037273403,6037273403,2022,332,262,78.919998,246,16
1400000US06037273800,6037273800,2022,2460,1464,59.509998,1284,180
1400000US06037274202,6037274202,2022,275,230,83.639999,219,11
1400000US06037275200,6037275200,2022,498,474,95.18,431,43
1400000US06037275311,6037275311,2022,1312,559,42.610001,531,28
1400000US06037275400,6037275400,2022,300,157,52.330002,142,15
1400000US06037275500,6037275500,2022,802,531,66.209999,485,46
1400000US06037275603,6037275603,2022,238,93,39.080002,81,12
1400000US06037275604,6037275604,2022,422,47,11.14,41,6
1400000US06037275605,6037275605,2022,290,256,88.279999,221,35
1400000US06037276000,6037276000,2022,173,107,61.849998,96,11
1400000US06037276400,6037276400,2022,276,85,30.799999,81,4
1400000US06037276605,6037276605,2022,164,99,60.369999,84,15
1400000US06037276607,6037276607,2022,201,146,72.639999,122,24
1400000US06037276608,6037276608,2022,1004,659,65.639999,581,78
1400000US06037277000,6037277000,2022,1570,694,44.200001,624,70
1400000US06037277100,6037277100,2022,392,74,18.879999,58,16
1400000US06037291120,6037291120,2022,505,470,93.07,451,19
1400000US06037291210,6037291210,2022,416,385,92.550003,372,13
1400000US06037291220,6037291220,2022,350,324,92.57,290,34
1400000US06037291300,6037291300,2022,782,614,78.519997,580,34
1400000US06037293204,6037293204,2022,417,359,86.089996,344,15
1400000US06037293302,6037293302,2022,2538,2011,79.239998,1812,199
1400000US06037293304,6037293304,2022,406,381,93.839996,370,11
1400000US06037294110,6037294110,2022,3185,2844,89.290001,2647,197
1400000US06037294200,6037294200,2022,1376,1296,94.190002,1233,63
1400000US06037294302,6037294302,2022,439,271,61.73,195,76
1400000US06037294410,6037294410,2022,270,262,97.040001,258,4
1400000US06037294510,6037294510,2022,617,569,92.220001,540,29
1400000US06037294520,6037294520,2022,335,314,93.730003,300,14
1400000US06037294610,6037294610,2022,1100,997,90.639999,947,50
1400000US06037294620,6037294620,2022,485,467,96.290001,450,17
1400000US06037294830,6037294830,2022,629,609,96.82,589,20
1400000US06037294900,6037294900,2022,507,493,97.239998,480,13
1400000US06037295103,6037295103,2022,715,368,51.470001,321,47
1400000US06037296220,6037296220,2022,938,638,68.019997,526,112
1400000US06037296300,6037296300,2022,548,302,55.110001,255,47
1400000US06037296401,6037296401,2022,272,182,66.910004,163,19
1400000US06037296500,6037296500,2022,605,563,93.059998,550,13
1400000US06037296600,6037296600,2022,306,289,94.440002,278,11
1400000US06037296901,6037296901,2022,4012,2664,66.400002,2402,262
1400000US06037297120,6037297120,2022,347,314,90.489998,300,14
1400000US06037297202,6037297202,2022,378,319,84.389999,283,36
1400000US06037297400,6037297400,2022,415,204,49.16,179,25
1400000US06037297501,6037297501,2022,286,101,35.310001,84,17
1400000US06037297601,6037297601,2022,51,43,84.309998,43,0
1400000US06037297602,6037297602,2022,290,183,63.099998,145,38
1400000US06037300200,6037300200,2022,2359,378,16.02,328,50
1400000US06037300301,6037300301,2022,3069,1146,37.34,958,188
1400000US06037300400,6037300400,2022,448,94,20.98,80,14
1400000US06037300501,6037300501,2022,2857,572,20.02,500,72
1400000US06037300602,6037300602,2022,585,98,16.75,77,21
1400000US06037300800,6037300800,2022,612,141,23.040001,124,17
1400000US06037300902,6037300902,2022,456,128,28.07,122,6
1400000US06037301000,6037301000,2022,1062,515,48.490002,456,59
1400000US06037301206,6037301206,2022,3297,1631,49.470001,1348,283
1400000US06037301400,6037301400,2022,787,369,46.889999,336,33
1400000US06037301502,6037301502,2022,653,426,65.239998,384,42
1400000US06037301602,6037301602,2022,580,76,13.1,73,3
1400000US06037301801,6037301801,2022,422,274,64.93,247,27
1400000US06037301902,6037301902,2022,867,444,51.209999,418,26
1400000US06037302002,6037302002,2022,71,35,49.299999,35,0
1400000US06037302004,6037302004,2022,441,327,74.150002,288,39
1400000US06037302104,6037302104,2022,1922,1036,53.900002,937,99
1400000US06037302302,6037302302,2022,816,359,44,304,55
1400000US06037302504,6037302504,2022,2026,1494,73.739998,1339,155
1400000US06037302505,6037302505,2022,442,336,76.019997,293,43
1400000US06037310201,6037310201,2022,579,174,30.049999,160,14
1400000US06037310300,6037310300,2022,2114,652,30.84,590,62
1400000US06037310601,6037310601,2022,419,210,50.119999,186,24
1400000US06037310602,6037310602,2022,2431,803,33.029999,752,51
1400000US06037310703,6037310703,2022,733,349,47.610001,323,26
1400000US06037310705,6037310705,2022,12,6,50,6,0
1400000US06037310800,6037310800,2022,2692,746,27.709999,692,54
1400000US06037310900,6037310900,2022,624,134,21.469999,124,10
1400000US06037311000,6037311000,2022,927,302,32.580002,281,21
1400000US06037311100,6037311100,2022,851,276,32.43,245,31
1400000US06037311200,6037311200,2022,182,49,26.92,49,0
1400000US06037311500,6037311500,2022,1133,171,15.09,152,19
1400000US06037311700,6037311700,2022,968,288,29.75,248,40
1400000US06037311802,6037311802,2022,426,154,36.150002,137,17
1400000US06037320101,6037320101,2022,443,396,89.389999,375,21
1400000US06037320102,6037320102,2022,1592,1464,91.959999,1378,86
1400000US06037320201,6037320201,2022,1197,1120,93.57,1044,76
1400000US06037320202,6037320202,2022,427,394,92.269997,369,25
1400000US06037320300,6037320300,2022,1596,1513,94.800003,1425,88
1400000US06037400205,6037400205,2022,18,18,100,18,0
1400000US06037400208,6037400208,2022,555,103,18.559999,88,15
1400000US06037400304,6037400304,2022,915,430,46.990002,388,42
1400000US06037400402,6037400402,2022,2222,938,42.209999,618,320
1400000US06037400403,6037400403,2022,20,20,100,20,0
1400000US06037400404,6037400404,2022,556,137,24.639999,89,48
1400000US06037400501,6037400501,2022,763,255,33.419998,176,79
1400000US06037400602,6037400602,2022,573,398,69.459999,333,65
1400000US06037400605,6037400605,2022,334,260,77.839996,232,28
1400000US06037400801,6037400801,2022,1882,1017,54.040001,755,262
1400000US06037401001,6037401001,2022,563,206,36.59,131,75
1400000US06037401202,6037401202,2022,837,384,45.880001,299,85
1400000US06037401203,6037401203,2022,276,204,73.910004,153,51
1400000US06037401311,6037401311,2022,1088,366,33.639999,287,79
1400000US06037401312,6037401312,2022,2150,822,38.23,686,136
1400000US06037401601,6037401601,2022,439,135,30.75,108,27
1400000US06037401602,6037401602,2022,2484,839,33.779999,716,123
1400000US06037401705,6037401705,2022,441,169,38.32,167,2
1400000US06037401707,6037401707,2022,322,308,95.650002,271,37
1400000US06037401801,6037401801,2022,630,117,18.57,111,6
1400000US06037401802,6037401802,2022,2972,736,24.76,698,38
1400000US06037401902,6037401902,2022,1799,459,25.51,427,32
1400000US06037402001,6037402001,2022,332,170,51.200001,163,7
1400000US06037402002,6037402002,2022,307,105,34.200001,99,6
1400000US06037402101,6037402101,2022,295,282,95.589996,247,35
1400000US06037402102,6037402102,2022,2056,1916,93.190002,1656,260
1400000US06037402200,6037402200,2022,332,299,90.059998,239,60
1400000US06037402301,6037402301,2022,1058,996,94.139999,861,135
1400000US06037402303,6037402303,2022,307,295,96.089996,261,34
1400000US06037402403,6037402403,2022,1119,703,62.82,618,85
1400000US06037402405,6037402405,2022,888,849,95.610001,728,121
1400000US06037402406,6037402406,2022,952,922,96.849998,831,91
1400000US06037402501,6037402501,2022,1054,1031,97.82,945,86
1400000US06037402503,6037402503,2022,788,769,97.589996,678,91
1400000US06037402504,6037402504,2022,400,391,97.75,367,24
1400000US06037402601,6037402601,2022,612,596,97.389999,546,50
1400000US06037402702,6037402702,2022,1261,1065,84.459999,879,186
1400000US06037402703,6037402703,2022,279,271,97.129997,220,51
1400000US06037402705,6037402705,2022,482,461,95.639999,417,44
1400000US06037402706,6037402706,2022,233,228,97.849998,201,27
1400000US06037402902,6037402902,2022,540,516,95.559998,441,75
1400000US06037402903,6037402903,2022,1346,1284,95.389999,1143,141
1400000US06037403000,6037403000,2022,2851,2761,96.839996,2421,340
1400000US06037403316,6037403316,2022,803,604,75.220001,464,140
1400000US06037403317,6037403317,2022,1901,1412,74.279999,1061,351
1400000US06037403318,6037403318,2022,409,313,76.529999,253,60
1400000US06037403320,6037403320,2022,434,206,47.470001,156,50
1400000US06037403321,6037403321,2022,277,196,70.760002,138,58
1400000US06037403323,6037403323,2022,1618,380,23.49,363,17
1400000US06037403324,6037403324,2022,641,180,28.08,172,8
1400000US06037403325,6037403325,2022,3802,899,23.65,868,31
1400000US06037403326,6037403326,2022,644,167,25.93,159,8
1400000US06037403327,6037403327,2022,263,186,70.720001,137,49
1400000US06037403401,6037403401,2022,464,132,28.450001,129,3
1400000US06037403402,6037403402,2022,2761,730,26.440001,691,39
1400000US06037403404,6037403404,2022,1130,282,24.959999,263,19
1400000US06037403407,6037403407,2022,606,132,21.780001,125,7
1400000US06037403408,6037403408,2022,885,484,54.689999,362,122
1400000US06037403409,6037403409,2022,574,159,27.700001,155,4
1400000US06037403601,6037403601,2022,804,535,66.540001,432,103
1400000US06037403702,6037403702,2022,1701,1153,67.779999,891,262
1400000US06037403703,6037403703,2022,331,252,76.129997,208,44
1400000US06037403722,6037403722,2022,893,597,66.849998,489,108
1400000US06037403801,6037403801,2022,958,722,75.370003,617,105
1400000US06037403901,6037403901,2022,50,40,80,31,9
1400000US06037403902,6037403902,2022,338,214,63.310001,154,60
1400000US06037404000,6037404000,2022,524,439,83.779999,389,50
1400000US06037404100,6037404100,2022,271,215,79.339996,197,18
1400000US06037404201,6037404201,2022,1669,1341,80.349998,1203,138
1400000US06037404203,6037404203,2022,290,211,72.760002,191,20
1400000US06037404401,6037404401,2022,393,301,76.589996,269,32
1400000US06037404402,6037404402,2022,632,457,72.309998,415,42
1400000US06037404503,6037404503,2022,443,326,73.589996,311,15
1400000US06037404504,6037404504,2022,476,400,84.029999,371,29
1400000US06037404600,6037404600,2022,1945,1585,81.489998,1340,245
1400000US06037404701,6037404701,2022,531,500,94.160004,424,76
1400000US06037404702,6037404702,2022,470,452,96.169998,382,70
1400000US06037404804,6037404804,2022,2643,2462,93.150002,2045,417
1400000US06037404805,6037404805,2022,413,382,92.489998,323,59
1400000US06037404806,6037404806,2022,898,852,94.879997,732,120
1400000US06037404901,6037404901,2022,440,398,90.449997,332,66
1400000US06037404903,6037404903,2022,338,311,92.010002,273,38
1400000US06037405001,6037405001,2022,780,721,92.440002,585,136
1400000US06037405002,6037405002,2022,262,250,95.419998,213,37
1400000US06037405101,6037405101,2022,1271,1173,92.290001,980,193
1400000US06037405201,6037405201,2022,1803,1685,93.459999,1416,269
1400000US06037405202,6037405202,2022,690,647,93.769997,580,67
1400000US06037405302,6037405302,2022,437,291,66.589996,263,28
1400000US06037405400,6037405400,2022,421,295,70.07,244,51
1400000US06037405600,6037405600,2022,928,642,69.18,518,124
1400000US06037405701,6037405701,2022,767,615,80.18,500,115
1400000US06037405702,6037405702,2022,1253,894,71.349998,763,131
1400000US06037405800,6037405800,2022,1413,1105,78.199997,974,131
1400000US06037406000,6037406000,2022,1676,1145,68.32,968,177
1400000US06037406103,6037406103,2022,552,399,72.279999,338,61
1400000US06037406201,6037406201,2022,1071,763,71.239998,648,115
1400000US06037406300,6037406300,2022,2312,1239,53.59,936,303
1400000US06037406413,6037406413,2022,1364,843,61.799999,726,117
1400000US06037406601,6037406601,2022,3325,2235,67.220001,1971,264
1400000US06037406602,6037406602,2022,319,238,74.610001,213,25
1400000US06037406701,6037406701,2022,224,170,75.889999,147,23
1400000US06037406702,6037406702,2022,208,157,75.480003,134,23
1400000US06037406801,6037406801,2022,1979,1348,68.120003,1176,172
1400000US06037406903,6037406903,2022,2157,1382,64.07,1155,227
1400000US06037407001,6037407001,2022,313,282,90.099998,268,14
1400000US06037407002,6037407002,2022,366,334,91.260002,302,32
1400000US06037407101,6037407101,2022,1449,1175,81.089996,1065,110
1400000US06037407201,6037407201,2022,278,203,73.019997,188,15
1400000US06037407301,6037407301,2022,321,227,70.720001,211,16
1400000US06037407302,6037407302,2022,830,614,73.980003,542,72
1400000US06037407501,6037407501,2022,806,613,76.050003,511,102
1400000US06037407502,6037407502,2022,595,432,72.610001,370,62
1400000US06037407602,6037407602,2022,423,368,87,310,58
1400000US06037407701,6037407701,2022,444,379,85.360001,362,17
1400000US06037407702,6037407702,2022,1296,1060,81.790001,908,152
1400000US06037407801,6037407801,2022,399,285,71.43,255,30
1400000US06037407802,6037407802,2022,1830,1479,80.82,1279,200
1400000US06037407901,6037407901,2022,530,408,76.980003,325,83
1400000US06037408003,6037408003,2022,80,67,83.75,60,7
1400000US06037408135,6037408135,2022,574,483,84.150002,440,43
1400000US06037408136,6037408136,2022,345,211,61.16,202,9
1400000US06037408137,6037408137,2022,666,512,76.879997,452,60
1400000US06037408138,6037408138,2022,338,295,87.279999,277,18
1400000US06037408139,6037408139,2022,378,339,89.68,300,39
1400000US06037408140,6037408140,2022,556,445,80.040001,422,23
1400000US06037408141,6037408141,2022,2076,1585,76.349998,1444,141
1400000US06037408212,6037408212,2022,609,398,65.349998,320,78
1400000US06037408213,6037408213,2022,374,285,76.199997,262,23
1400000US06037408301,6037408301,2022,553,497,89.870003,472,25
1400000US06037408302,6037408302,2022,588,361,61.389999,304,57
1400000US06037408401,6037408401,2022,8,2,25,2,0
1400000US06037408402,6037408402,2022,760,571,75.129997,481,90
1400000US06037408503,6037408503,2022,850,482,56.709999,354,128
1400000US06037408504,6037408504,2022,591,339,57.360001,256,83
1400000US06037408505,6037408505,2022,1903,1256,66,994,262
1400000US06037408623,6037408623,2022,2052,1205,58.720001,864,341
1400000US06037408624,6037408624,2022,216,164,75.93,134,30
1400000US06037408625,6037408625,2022,1623,843,51.939999,598,245
1400000US06037408631,6037408631,2022,569,374,65.730003,313,61
1400000US06037408705,6037408705,2022,2758,1692,61.349998,1411,281
1400000US06037408707,6037408707,2022,876,224,25.57,216,8
1400000US06037408722,6037408722,2022,667,443,66.419998,352,91
1400000US06037408724,6037408724,2022,450,361,80.220001,339,22
1400000US06037408725,6037408725,2022,726,486,66.940002,419,67
1400000US06037408800,6037408800,2022,681,606,88.989998,603,3
1400000US06037408900,6037408900,2022,1738,620,35.669998,509,111
1400000US06037409000,6037409000,2022,527,484,91.839996,424,60
1400000US06037409100,6037409100,2022,320,250,78.129997,227,23
1400000US06037430003,6037430003,2022,340,138,40.59,121,17
1400000US06037430005,6037430005,2022,303,192,63.369999,176,16
1400000US06037430101,6037430101,2022,1863,666,35.75,605,61
1400000US06037430102,6037430102,2022,380,274,72.110001,250,24
1400000US06037430200,6037430200,2022,791,285,36.029999,262,23
1400000US06037430302,6037430302,2022,471,195,41.400002,178,17
1400000US06037430400,6037430400,2022,1195,233,19.5,211,22
1400000US06037430502,6037430502,2022,1167,437,37.450001,257,180
1400000US06037430701,6037430701,2022,539,176,32.650002,153,23
1400000US06037430721,6037430721,2022,2962,819,27.65,718,101
1400000US06037430801,6037430801,2022,889,262,29.469999,239,23
1400000US06037430802,6037430802,2022,1222,345,28.23,301,44
1400000US06037431002,6037431002,2022,586,364,62.119999,324,40
1400000US06037431003,6037431003,2022,1520,683,44.93,637,46
1400000US06037431004,6037431004,2022,1521,750,49.310001,698,52
1400000US06037431100,6037431100,2022,447,341,76.290001,279,62
1400000US06037431200,6037431200,2022,404,301,74.5,290,11
1400000US06037431400,6037431400,2022,475,291,61.259998,257,34
1400000US06037431501,6037431501,2022,351,259,73.790001,163,96
1400000US06037431502,6037431502,2022,653,534,81.779999,348,186
1400000US06037431600,6037431600,2022,467,126,26.98,115,11
1400000US06037431701,6037431701,2022,1247,398,31.92,346,52
1400000US06037431800,6037431800,2022,1824,591,32.400002,545,46
1400000US06037431900,6037431900,2022,698,292,41.830002,256,36
1400000US06037432002,6037432002,2022,887,360,40.59,336,24
1400000US06037432102,6037432102,2022,455,172,37.799999,155,17
1400000US06037432201,6037432201,2022,499,341,68.339996,273,68
1400000US06037432202,6037432202,2022,2475,1913,77.290001,1576,337
1400000US06037432300,6037432300,2022,792,691,87.25,491,200
1400000US06037432401,6037432401,2022,2550,2148,84.239998,1715,433
1400000US06037432402,6037432402,2022,467,389,83.300003,286,103
1400000US06037432501,6037432501,2022,326,272,83.440002,207,65
1400000US06037432602,6037432602,2022,1289,1059,82.160004,857,202
1400000US06037432700,6037432700,2022,5,5,100,4,1
1400000US06037432801,6037432801,2022,501,461,92.019997,340,121
1400000US06037432902,6037432902,2022,372,298,80.110001,255,43
1400000US06037433103,6037433103,2022,371,343,92.449997,265,78
1400000US06037433200,6037433200,2022,2545,2305,90.57,1858,447
1400000US06037433305,6037433305,2022,694,515,74.209999,505,10
1400000US06037433307,6037433307,2022,1004,704,70.120003,675,29
1400000US06037433505,6037433505,2022,1044,995,95.309998,725,270
1400000US06037433803,6037433803,2022,1663,1426,85.75,1220,206
1400000US06037433804,6037433804,2022,1396,1095,78.440002,1021,74
1400000US06037433901,6037433901,2022,640,467,72.970001,458,9
1400000US06037433903,6037433903,2022,1024,759,74.120003,744,15
1400000US06037434001,6037434001,2022,1292,1186,91.800003,1024,162
1400000US06037434003,6037434003,2022,494,327,66.190002,320,7
1400000US06037434100,6037434100,2022,463,351,75.809998,312,39
1400000US06037460002,6037460002,2022,387,204,52.709999,157,47
1400000US06037460101,6037460101,2022,357,61,17.09,60,1
1400000US06037460200,6037460200,2022,166,117,70.480003,102,15
1400000US06037460301,6037460301,2022,379,159,41.950001,151,8
1400000US06037460302,6037460302,2022,463,109,23.540001,102,7
1400000US06037460501,6037460501,2022,644,25,3.8800001,25,0
1400000US06037460502,6037460502,2022,619,27,4.3600001,27,0
1400000US06037460601,6037460601,2022,608,29,4.77,28,1
1400000US06037460700,6037460700,2022,1982,107,5.4000001,106,1
1400000US06037460900,6037460900,2022,1216,850,69.900002,731,119
1400000US06037461000,6037461000,2022,608,363,59.700001,299,64
1400000US06037461100,6037461100,2022,435,285,65.519997,246,39
1400000US06037461200,6037461200,2022,485,387,79.790001,343,44
1400000US06037461300,6037461300,2022,290,206,71.029999,180,26
1400000US06037461400,6037461400,2022,566,499,88.160004,410,89
1400000US06037461502,6037461502,2022,947,803,84.790001,743,60
1400000US06037462100,6037462100,2022,446,406,91.029999,388,18
1400000US06037462500,6037462500,2022,2279,1635,71.739998,1314,321
1400000US06037462600,6037462600,2022,1955,1464,74.879997,1131,333
1400000US06037462900,6037462900,2022,124,112,90.32,107,5
1400000US06037463000,6037463000,2022,395,127,32.150002,72,55
1400000US06037463200,6037463200,2022,464,297,64.010002,258,39
1400000US06037463300,6037463300,2022,507,262,51.68,193,69
1400000US06037463601,6037463601,2022,871,688,78.989998,616,72
1400000US06037463800,6037463800,2022,386,155,40.16,122,33
1400000US06037464000,6037464000,2022,1043,634,60.790001,529,105
1400000US06037464101,6037464101,2022,1229,86,7,85,1
1400000US06037464200,6037464200,2022,845,74,8.7600002,72,2
1400000US06037480002,6037480002,2022,902,174,19.290001,131,43
1400000US06037480012,6037480012,2022,1315,466,35.439999,408,58
1400000US06037480201,6037480201,2022,274,138,50.360001,101,37
1400000US06037480202,6037480202,2022,446,241,54.040001,183,58
1400000US06037480302,6037480302,2022,373,226,60.59,212,14
1400000US06037480304,6037480304,2022,2895,1673,57.790001,1493,180
1400000US06037480400,6037480400,2022,1540,776,50.389999,686,90
1400000US06037480500,6037480500,2022,1907,279,14.63,274,5
1400000US06037480702,6037480702,2022,564,65,11.52,65,0
1400000US06037480703,6037480703,2022,670,90,13.43,87,3
1400000US06037480704,6037480704,2022,1415,191,13.5,181,10
1400000US06037480803,6037480803,2022,375,204,54.400002,180,24
1400000US06037480804,6037480804,2022,676,327,48.369999,303,24
1400000US06037480901,6037480901,2022,213,150,70.419998,141,9
1400000US06037480903,6037480903,2022,511,320,62.619999,291,29
1400000US06037481101,6037481101,2022,301,212,70.43,180,32
1400000US06037481102,6037481102,2022,24,22,91.669998,20,2
1400000US06037481103,6037481103,2022,1748,1177,67.330002,1088,89
1400000US06037481203,6037481203,2022,1379,989,71.720001,809,180
1400000US06037481300,6037481300,2022,500,318,63.599998,252,66
1400000US06037481401,6037481401,2022,579,422,72.879997,320,102
1400000US06037481403,6037481403,2022,401,274,68.330002,260,14
1400000US06037481404,6037481404,2022,1565,1019,65.110001,762,257
1400000US06037481500,6037481500,2022,2189,1096,50.07,955,141
1400000US06037481606,6037481606,2022,712,437,61.380001,393,44
1400000US06037481901,6037481901,2022,577,272,47.139999,247,25
1400000US06037482001,6037482001,2022,933,342,36.66,301,41
1400000US06037482002,6037482002,2022,829,285,34.380001,253,32
1400000US06037482101,6037482101,2022,715,478,66.849998,445,33
1400000US06037482102,6037482102,2022,704,300,42.610001,270,30
1400000US06037482202,6037482202,2022,515,256,49.709999,236,20
1400000US06037482303,6037482303,2022,179,141,78.769997,140,1
1400000US06037482304,6037482304,2022,417,293,70.260002,290,3
1400000US06037482401,6037482401,2022,304,200,65.790001,195,5
1400000US06037482403,6037482403,2022,993,692,69.690002,664,28
1400000US06037482502,6037482502,2022,1021,646,63.27,625,21
1400000US06037482522,6037482522,2022,356,190,53.369999,167,23
1400000US06037482600,6037482600,2022,411,219,53.279999,192,27
1400000US06037482701,6037482701,2022,512,344,67.190002,321,23
1400000US06037482801,6037482801,2022,551,339,61.52,312,27
1400000US06037500202,6037500202,2022,3620,2040,56.349998,1416,624
1400000US06037500203,6037500203,2022,505,177,35.049999,104,73
1400000US06037500300,6037500300,2022,334,219,65.57,196,23
1400000US06037500402,6037500402,2022,508,390,76.769997,334,56
1400000US06037500404,6037500404,2022,327,221,67.580002,198,23
1400000US06037500600,6037500600,2022,557,400,71.809998,368,32
1400000US06037500700,6037500700,2022,422,271,64.220001,248,23
1400000US06037500800,6037500800,2022,2714,1829,67.389999,1545,284
1400000US06037500900,6037500900,2022,718,557,77.580002,497,60
1400000US06037501001,6037501001,2022,321,249,77.57,210,39
1400000US06037501002,6037501002,2022,1388,1117,80.480003,994,123
1400000US06037501200,6037501200,2022,328,259,78.959999,233,26
1400000US06037501302,6037501302,2022,1226,988,80.589996,888,100
1400000US06037501400,6037501400,2022,1782,1475,82.769997,1150,325
1400000US06037501600,6037501600,2022,358,270,75.419998,247,23
1400000US06037501700,6037501700,2022,657,297,45.209999,190,107
1400000US06037501804,6037501804,2022,378,324,85.709999,279,45
1400000US06037502003,6037502003,2022,374,311,83.160004,263,48
1400000US06037502005,6037502005,2022,487,405,83.160004,287,118
1400000US06037502200,6037502200,2022,528,312,59.09,257,55
1400000US06037502303,6037502303,2022,2192,1843,84.080002,1555,288
1400000US06037502401,6037502401,2022,1103,775,70.260002,659,116
1400000US06037502500,6037502500,2022,95,54,56.84,46,8
1400000US06037502602,6037502602,2022,363,254,69.970001,224,30
1400000US06037502603,6037502603,2022,512,370,72.269997,302,68
1400000US06037502604,6037502604,2022,318,247,77.669998,204,43
1400000US06037502700,6037502700,2022,611,360,58.919998,347,13
1400000US06037502801,6037502801,2022,3190,2122,66.519997,1694,428
1400000US06037503103,6037503103,2022,395,344,87.089996,306,38
1400000US06037503105,6037503105,2022,483,417,86.339996,359,58
1400000US06037503201,6037503201,2022,433,291,67.209999,230,61
1400000US06037503202,6037503202,2022,349,298,85.389999,255,43
1400000US06037503302,6037503302,2022,3066,2353,76.739998,1822,531
1400000US06037503401,6037503401,2022,415,230,55.419998,184,46
1400000US06037503402,6037503402,2022,549,236,42.990002,149,87
1400000US06037503501,6037503501,2022,895,582,65.029999,456,126
1400000US06037503502,6037503502,2022,603,472,78.279999,363,109
1400000US06037503602,6037503602,2022,2441,1108,45.389999,1008,100
1400000US06037503701,6037503701,2022,1624,826,50.860001,565,261
1400000US06037503702,6037503702,2022,1268,676,53.310001,461,215
1400000US06037503705,6037503705,2022,258,127,49.220001,118,9
1400000US06037503801,6037503801,2022,548,274,50,258,16
1400000US06037503802,6037503802,2022,306,160,52.290001,150,10
1400000US06037503902,6037503902,2022,409,173,42.299999,162,11
1400000US06037504002,6037504002,2022,1419,640,45.099998,606,34
1400000US06037504101,6037504101,2022,260,187,71.919998,178,9
1400000US06037504200,6037504200,2022,1658,1436,86.610001,1216,220
1400000US06037530005,6037530005,2022,2406,1609,66.870003,1459,150
1400000US06037530007,6037530007,2022,1641,1192,72.639999,1103,89
1400000US06037530101,6037530101,2022,244,194,79.510002,182,12
1400000US06037530102,6037530102,2022,3845,2896,75.32,2690,206
1400000US06037530202,6037530202,2022,644,506,78.57,478,28
1400000US06037530203,6037530203,2022,455,338,74.290001,320,18
1400000US06037530301,6037530301,2022,3149,2994,95.080002,2846,148
1400000US06037530400,6037530400,2022,1737,1491,85.839996,1319,172
1400000US06037530500,6037530500,2022,517,480,92.839996,456,24
1400000US06037530603,6037530603,2022,540,459,85,427,32
1400000US06037530700,6037530700,2022,560,482,86.07,439,43
1400000US06037530801,6037530801,2022,292,280,95.889999,276,4
1400000US06037530902,6037530902,2022,455,435,95.599998,426,9
1400000US06037531000,6037531000,2022,3061,2797,91.379997,2684,113
1400000US06037531101,6037531101,2022,16061,12431,77.400002,11955,476
1400000US06037531102,6037531102,2022,690,664,96.230003,647,17
1400000US06037531201,6037531201,2022,659,632,95.900002,613,19
1400000US06037531202,6037531202,2022,85,81,95.290001,76,5
1400000US06037531302,6037531302,2022,1091,1008,92.389999,913,95
1400000US06037531502,6037531502,2022,782,732,93.610001,706,26
1400000US06037531503,6037531503,2022,418,403,96.410004,379,24
1400000US06037531603,6037531603,2022,1199,1117,93.160004,1076,41
1400000US06037531604,6037531604,2022,255,243,95.290001,217,26
1400000US06037531701,6037531701,2022,558,452,81,368,84
1400000US06037531702,6037531702,2022,443,342,77.199997,333,9
1400000US06037531800,6037531800,2022,681,529,77.68,495,34
1400000US06037531902,6037531902,2022,390,318,81.540001,304,14
1400000US06037532002,6037532002,2022,448,308,68.75,285,23
1400000US06037532101,6037532101,2022,19,13,68.419998,13,0
1400000US06037532102,6037532102,2022,763,615,80.599998,596,19
1400000US06037532200,6037532200,2022,131,100,76.339996,96,4
1400000US06037532302,6037532302,2022,334,258,77.25,250,8
1400000US06037532303,6037532303,2022,648,444,68.519997,413,31
1400000US06037532500,6037532500,2022,2875,2712,94.330002,2564,148
1400000US06037532605,6037532605,2022,273,242,88.639999,235,7
1400000US06037532607,6037532607,2022,2036,1950,95.779999,1871,79
1400000US06037532700,6037532700,2022,816,784,96.080002,748,36
1400000US06037532800,6037532800,2022,2544,2504,98.43,2462,42
1400000US06037532900,6037532900,2022,1472,1439,97.760002,1404,35
1400000US06037533103,6037533103,2022,2591,2384,92.010002,2251,133
1400000US06037533108,6037533108,2022,1996,1915,95.940002,1830,85
1400000US06037533201,6037533201,2022,463,436,94.169998,410,26
1400000US06037533204,6037533204,2022,441,400,90.699997,387,13
1400000US06037533402,6037533402,2022,1334,1251,93.779999,1164,87
1400000US06037533403,6037533403,2022,1408,1352,96.019997,1297,55
1400000US06037533501,6037533501,2022,1233,1189,96.43,1142,47
1400000US06037533504,6037533504,2022,737,665,90.230003,596,69
1400000US06037533601,6037533601,2022,659,618,93.779999,594,24
1400000US06037533602,6037533602,2022,1894,1749,92.339996,1649,100
1400000US06037533603,6037533603,2022,2360,2233,94.620003,2082,151
1400000US06037533701,6037533701,2022,1212,1131,93.32,1053,78
1400000US06037533703,6037533703,2022,478,443,92.68,425,18
1400000US06037533804,6037533804,2022,540,497,92.040001,458,39
1400000US06037533901,6037533901,2022,3158,2488,78.779999,2335,153
1400000US06037533902,6037533902,2022,490,403,82.239998,390,13
1400000US06037534001,6037534001,2022,659,519,78.760002,487,32
1400000US06037534002,6037534002,2022,660,521,78.940002,491,30
1400000US06037534102,6037534102,2022,918,718,78.209999,677,41
1400000US06037534201,6037534201,2022,839,665,79.260002,635,30
1400000US06037534302,6037534302,2022,323,306,94.739998,285,21
1400000US06037534404,6037534404,2022,1024,965,94.239998,933,32
1400000US06037534405,6037534405,2022,1336,1305,97.68,1276,29
1400000US06037534406,6037534406,2022,1143,1097,95.980003,1064,33
1400000US06037534501,6037534501,2022,730,686,93.970001,657,29
1400000US06037534803,6037534803,2022,523,498,95.220001,478,20
1400000US06037534804,6037534804,2022,436,356,81.650002,333,23
1400000US06037534900,6037534900,2022,2342,2212,94.449997,2038,174
1400000US06037535001,6037535001,2022,1370,1335,97.449997,1315,20
1400000US06037535101,6037535101,2022,2757,2679,97.169998,2582,97
1400000US06037535102,6037535102,2022,512,502,98.050003,484,18
1400000US06037535300,6037535300,2022,1096,1009,92.059998,959,50
1400000US06037535501,6037535501,2022,467,448,95.93,432,16
1400000US06037535603,6037535603,2022,425,408,96,388,20
1400000US06037535604,6037535604,2022,426,409,96.010002,389,20
1400000US06037535605,6037535605,2022,1614,1411,87.419998,1233,178
1400000US06037535607,6037535607,2022,3758,3549,94.440002,3386,163
1400000US06037535701,6037535701,2022,436,412,94.5,383,29
1400000US06037535702,6037535702,2022,2420,2231,92.190002,2104,127
1400000US06037535803,6037535803,2022,312,304,97.440002,288,16
1400000US06037535901,6037535901,2022,1322,1186,89.709999,1086,100
1400000US06037536000,6037536000,2022,2053,1872,91.18,1717,155
1400000US06037536103,6037536103,2022,415,362,87.230003,334,28
1400000US06037536104,6037536104,2022,1956,1746,89.260002,1604,142
1400000US06037536201,6037536201,2022,840,768,91.43,641,127
1400000US06037540000,6037540000,2022,2680,2498,93.209999,2211,287
1400000US06037540101,6037540101,2022,2818,2622,93.040001,2257,365
1400000US06037540202,6037540202,2022,1810,1666,92.040001,1492,174
1400000US06037540203,6037540203,2022,1176,1104,93.879997,987,117
1400000US06037540300,6037540300,2022,414,394,95.169998,351,43
1400000US06037540400,6037540400,2022,265,259,97.739998,253,6
1400000US06037540502,6037540502,2022,601,555,92.349998,510,45
1400000US06037540600,6037540600,2022,342,306,89.470001,302,4
1400000US06037540700,6037540700,2022,2072,1861,89.82,1751,110
1400000US06037540800,6037540800,2022,1379,1205,87.379997,1133,72
1400000US06037540901,6037540901,2022,548,535,97.629997,521,14
1400000US06037540902,6037540902,2022,1465,1246,85.050003,1146,100
1400000US06037541003,6037541003,2022,465,324,69.68,279,45
1400000US06037541100,6037541100,2022,380,320,84.209999,291,29
1400000US06037541200,6037541200,2022,931,843,90.550003,780,63
1400000US06037541300,6037541300,2022,1413,1264,89.459999,1151,113
1400000US06037541401,6037541401,2022,471,403,85.559998,380,23
1400000US06037541500,6037541500,2022,714,617,86.410004,568,49
1400000US06037541603,6037541603,2022,893,675,75.589996,660,15
1400000US06037541605,6037541605,2022,490,423,86.330002,398,25
1400000US06037541700,6037541700,2022,2162,2004,92.690002,1816,188
1400000US06037541802,6037541802,2022,497,451,90.739998,401,50
1400000US06037542000,6037542000,2022,1034,884,85.489998,840,44
1400000US06037542104,6037542104,2022,554,521,94.040001,489,32
1400000US06037542106,6037542106,2022,2921,2600,89.010002,2432,168
1400000US06037542200,6037542200,2022,729,637,87.379997,598,39
1400000US06037542401,6037542401,2022,1142,1034,90.540001,963,71
1400000US06037542402,6037542402,2022,1866,1664,89.169998,1572,92
1400000US06037542502,6037542502,2022,15,11,73.330002,10,1
1400000US06037542601,6037542601,2022,463,406,87.690002,387,19
1400000US06037542700,6037542700,2022,1093,954,87.279999,914,40
1400000US06037542800,6037542800,2022,629,555,88.239998,506,49
1400000US06037542900,6037542900,2022,493,401,81.339996,360,41
1400000US06037543000,6037543000,2022,619,536,86.589996,490,46
1400000US06037543100,6037543100,2022,801,675,84.269997,636,39
1400000US06037543201,6037543201,2022,599,513,85.639999,489,24
1400000US06037543203,6037543203,2022,189,167,88.360001,157,10
1400000US06037543304,6037543304,2022,239,213,89.120003,198,15
1400000US06037543306,6037543306,2022,262,174,66.410004,147,27
1400000US06037543321,6037543321,2022,660,221,33.48,200,21
1400000US06037543322,6037543322,2022,1139,920,80.769997,849,71
1400000US06037543400,6037543400,2022,241,192,79.669998,142,50
1400000US06037543501,6037543501,2022,1474,1049,71.169998,893,156
1400000US06037543503,6037543503,2022,842,717,85.150002,685,32
1400000US06037543601,6037543601,2022,698,491,70.339996,424,67
1400000US06037543607,6037543607,2022,362,218,60.220001,164,54
1400000US06037543701,6037543701,2022,2759,2030,73.580002,1704,326
1400000US06037543705,6037543705,2022,447,404,90.379997,374,30
1400000US06037543801,6037543801,2022,587,432,73.589996,378,54
1400000US06037543903,6037543903,2022,1058,823,77.790001,718,105
1400000US06037544001,6037544001,2022,430,359,83.489998,328,31
1400000US06037544002,6037544002,2022,760,525,69.080002,493,32
1400000US06037550101,6037550101,2022,328,190,57.93,190,0
1400000US06037550201,6037550201,2022,235,161,68.510002,161,0
1400000US06037550202,6037550202,2022,342,203,59.360001,203,0
1400000US06037550301,6037550301,2022,424,237,55.900002,237,0
1400000US06037550501,6037550501,2022,608,422,69.410004,362,60
1400000US06037550602,6037550602,2022,646,386,59.75,300,86
1400000US06037550700,6037550700,2022,2016,1279,63.439999,1039,240
1400000US06037550801,6037550801,2022,732,509,69.540001,434,75
1400000US06037550901,6037550901,2022,4264,2784,65.290001,2233,551
1400000US06037551001,6037551001,2022,687,404,58.810001,330,74
1400000US06037551002,6037551002,2022,1341,868,64.730003,697,171
1400000US06037551101,6037551101,2022,547,427,78.059998,374,53
1400000US06037551102,6037551102,2022,262,199,75.949997,170,29
1400000US06037551201,6037551201,2022,478,336,70.290001,281,55
1400000US06037551203,6037551203,2022,1123,853,75.959999,724,129
1400000US06037551204,6037551204,2022,684,525,76.75,448,77
1400000US06037551300,6037551300,2022,4273,2920,68.339996,2376,544
1400000US06037551402,6037551402,2022,591,424,71.739998,355,69
1400000US06037551501,6037551501,2022,1944,1389,71.449997,1144,245
1400000US06037551700,6037551700,2022,506,400,79.050003,338,62
1400000US06037551801,6037551801,2022,371,164,44.200001,127,37
1400000US06037551802,6037551802,2022,737,534,72.459999,455,79
1400000US06037551900,6037551900,2022,303,258,85.150002,239,19
1400000US06037552001,6037552001,2022,346,262,75.720001,247,15
1400000US06037552100,6037552100,2022,3253,2253,69.260002,2113,140
1400000US06037552301,6037552301,2022,556,427,76.800003,410,17
1400000US06037552302,6037552302,2022,1091,771,70.669998,731,40
1400000US06037552601,6037552601,2022,404,323,79.949997,307,16
1400000US06037552602,6037552602,2022,543,403,74.220001,370,33
1400000US06037552700,6037552700,2022,565,432,76.459999,418,14
1400000US06037552800,6037552800,2022,1872,1394,74.470001,1290,104
1400000US06037553000,6037553000,2022,441,336,76.190002,314,22
1400000US06037553100,6037553100,2022,2447,1980,80.919998,1620,360
1400000US06037553300,6037553300,2022,304,248,81.580002,210,38
1400000US06037553502,6037553502,2022,4944,4710,95.269997,4130,580
1400000US06037553504,6037553504,2022,554,516,93.139999,458,58
1400000US06037553601,6037553601,2022,496,455,91.730003,405,50
1400000US06037553701,6037553701,2022,414,394,95.169998,356,38
1400000US06037553702,6037553702,2022,1138,1100,96.660004,979,121
1400000US06037553802,6037553802,2022,932,878,94.209999,743,135
1400000US06037553901,6037553901,2022,934,827,88.540001,682,145
1400000US06037553902,6037553902,2022,1348,1281,95.029999,1119,162
1400000US06037554002,6037554002,2022,618,512,82.849998,429,83
1400000US06037554106,6037554106,2022,431,395,91.650002,317,78
1400000US06037554201,6037554201,2022,585,510,87.18,443,67
1400000US06037554405,6037554405,2022,827,598,72.309998,513,85
1400000US06037554511,6037554511,2022,1692,625,36.939999,396,229
1400000US06037554512,6037554512,2022,1525,471,30.889999,307,164
1400000US06037554514,6037554514,2022,461,322,69.849998,270,52
1400000US06037554515,6037554515,2022,694,321,46.25,213,108
1400000US06037554516,6037554516,2022,4274,2069,48.41,1467,602
1400000US06037554517,6037554517,2022,723,224,30.98,138,86
1400000US06037554518,6037554518,2022,608,201,33.060001,112,89
1400000US06037554521,6037554521,2022,1799,1028,57.139999,755,273
1400000US06037554522,6037554522,2022,1051,567,53.950001,417,150
1400000US06037554700,6037554700,2022,254,219,86.220001,213,6
1400000US06037554801,6037554801,2022,640,462,72.190002,377,85
1400000US06037554802,6037554802,2022,1329,916,68.919998,697,219
1400000US06037555001,6037555001,2022,352,263,74.720001,239,24
1400000US06037555002,6037555002,2022,281,230,81.849998,196,34
1400000US06037555105,6037555105,2022,1837,1558,84.809998,1325,233
1400000US06037555106,6037555106,2022,367,321,87.470001,292,29
1400000US06037555107,6037555107,2022,361,332,91.970001,297,35
1400000US06037555211,6037555211,2022,293,268,91.470001,257,11
1400000US06037555212,6037555212,2022,290,247,85.169998,236,11
1400000US06037555300,6037555300,2022,322,185,57.450001,185,0
1400000US06037570001,6037570001,2022,3139,2094,66.709999,1584,510
1400000US06037570002,6037570002,2022,475,409,86.110001,345,64
1400000US06037570100,6037570100,2022,620,578,93.230003,516,62
1400000US06037570202,6037570202,2022,824,555,67.349998,545,10
1400000US06037570203,6037570203,2022,523,389,74.379997,381,8
1400000US06037570402,6037570402,2022,844,621,73.580002,598,23
1400000US06037570403,6037570403,2022,625,438,70.080002,427,11
1400000US06037570504,6037570504,2022,3206,2072,64.629997,2008,64
1400000US06037570601,6037570601,2022,417,307,73.620003,304,3
1400000US06037570602,6037570602,2022,778,541,69.540001,519,22
1400000US06037570701,6037570701,2022,1042,847,81.290001,747,100
1400000US06037570800,6037570800,2022,1163,608,52.279999,458,150
1400000US06037570902,6037570902,2022,322,139,43.169998,134,5
1400000US06037571000,6037571000,2022,438,104,23.74,98,6
1400000US06037571101,6037571101,2022,294,111,37.759998,104,7
1400000US06037571102,6037571102,2022,2959,1489,50.32,1410,79
1400000US06037571202,6037571202,2022,1351,631,46.709999,585,46
1400000US06037571300,6037571300,2022,907,519,57.220001,494,25
1400000US06037571400,6037571400,2022,343,148,43.150002,142,6
1400000US06037571502,6037571502,2022,431,316,73.32,300,16
1400000US06037571701,6037571701,2022,1478,1078,72.940002,1046,32
1400000US06037571703,6037571703,2022,775,552,71.230003,541,11
1400000US06037571800,6037571800,2022,440,142,32.27,133,9
1400000US06037571900,6037571900,2022,2194,954,43.48,896,58
1400000US06037572202,6037572202,2022,1235,873,70.690002,838,35
1400000US06037572500,6037572500,2022,492,349,70.93,329,20
1400000US06037572600,6037572600,2022,802,557,69.449997,547,10
1400000US06037572700,6037572700,2022,561,365,65.059998,353,12
1400000US06037573101,6037573101,2022,875,573,65.489998,563,10
1400000US06037573201,6037573201,2022,682,497,72.870003,488,9
1400000US06037573300,6037573300,2022,361,230,63.709999,222,8
1400000US06037573402,6037573402,2022,1481,1062,71.709999,1015,47
1400000US06037573601,6037573601,2022,331,90,27.190001,89,1
1400000US06037573700,6037573700,2022,829,133,16.040001,119,14
1400000US06037573800,6037573800,2022,1170,391,33.419998,369,22
1400000US06037573902,6037573902,2022,768,126,16.41,115,11
1400000US06037574000,6037574000,2022,899,241,26.809999,225,16
1400000US06037574100,6037574100,2022,1415,441,31.17,408,33
1400000US06037574201,6037574201,2022,505,184,36.439999,176,8
1400000US06037574202,6037574202,2022,1628,1063,65.290001,1040,23
1400000US06037574300,6037574300,2022,1678,510,30.389999,472,38
1400000US06037574400,6037574400,2022,3611,1010,27.969999,948,62
1400000US06037574500,6037574500,2022,714,222,31.09,204,18
1400000US06037574602,6037574602,2022,460,131,28.48,120,11
1400000US06037574901,6037574901,2022,579,126,21.76,113,13
1400000US06037575001,6037575001,2022,313,208,66.449997,203,5
1400000US06037575002,6037575002,2022,305,194,63.610001,191,3
1400000US06037575101,6037575101,2022,729,547,75.029999,536,11
1400000US06037575201,6037575201,2022,604,443,73.339996,432,11
1400000US06037575300,6037575300,2022,4865,2822,58.009998,2711,111
1400000US06037575401,6037575401,2022,1383,1009,72.959999,988,21
1400000US06037575402,6037575402,2022,140,81,57.860001,78,3
1400000US06037575901,6037575901,2022,422,314,74.410004,312,2
1400000US06037576200,6037576200,2022,801,576,71.910004,566,10
1400000US06037576301,6037576301,2022,1002,637,63.57,619,18
1400000US06037576401,6037576401,2022,816,619,75.860001,607,12
1400000US06037576501,6037576501,2022,1095,826,75.43,816,10
1400000US06037576801,6037576801,2022,564,399,70.739998,392,7
1400000US06037576903,6037576903,2022,548,406,74.089996,394,12
1400000US06037577000,6037577000,2022,4563,2489,54.549999,2428,61
1400000US06037577100,6037577100,2022,737,318,43.150002,304,14
1400000US06037577501,6037577501,2022,276,63,22.83,59,4
1400000US06037577602,6037577602,2022,293,75,25.6,71,4
1400000US06037577606,6037577606,2022,1296,316,24.379999,308,8
1400000US06037577700,6037577700,2022,927,592,63.860001,547,45
1400000US06037577800,6037577800,2022,536,306,57.09,305,1
1400000US06037577900,6037577900,2022,432,256,59.259998,233,23
1400000US06037578000,6037578000,2022,2207,1507,68.279999,1473,34
1400000US06037599000,6037599000,2022,457,233,50.98,213,20
1400000US06037600201,6037600201,2022,707,695,98.300003,679,16
1400000US06037600302,6037600302,2022,1858,1777,95.639999,1738,39
1400000US06037600303,6037600303,2022,574,569,99.129997,557,12
1400000US06037600501,6037600501,2022,228,217,95.18,202,15
1400000US06037600602,6037600602,2022,1184,932,78.720001,892,40
1400000US06037600702,6037600702,2022,326,284,87.120003,250,34
1400000US06037600703,6037600703,2022,611,566,92.639999,491,75
1400000US06037600801,6037600801,2022,135,112,82.959999,104,8
1400000US06037600911,6037600911,2022,542,445,82.099998,409,36
1400000US06037601001,6037601001,2022,68,62,91.18,62,0
1400000US06037601002,6037601002,2022,387,328,84.75,304,24
1400000US06037601202,6037601202,2022,1030,878,85.239998,803,75
1400000US06037601211,6037601211,2022,1461,1251,85.629997,1148,103
1400000US06037601212,6037601212,2022,347,319,91.93,271,48
1400000US06037601301,6037601301,2022,648,497,76.699997,449,48
1400000US06037601303,6037601303,2022,1026,791,77.099998,696,95
1400000US06037601401,6037601401,2022,374,324,86.629997,295,29
1400000US06037601402,6037601402,2022,468,404,86.32,352,52
1400000US06037601502,6037601502,2022,1186,1039,87.610001,926,113
1400000US06037601600,6037601600,2022,1873,1693,90.389999,1521,172
1400000US06037601700,6037601700,2022,1945,1785,91.769997,1566,219
1400000US06037601802,6037601802,2022,527,488,92.599998,443,45
1400000US06037602003,6037602003,2022,363,320,88.150002,292,28
1400000US06037602104,6037602104,2022,439,324,73.800003,311,13
1400000US06037602106,6037602106,2022,1306,912,69.830002,832,80
1400000US06037602201,6037602201,2022,3510,2031,57.860001,1769,262
1400000US06037602302,6037602302,2022,1850,654,35.349998,478,176
1400000US06037602402,6037602402,2022,750,405,54,370,35
1400000US06037602403,6037602403,2022,1270,877,69.059998,831,46
1400000US06037602404,6037602404,2022,516,377,73.059998,356,21
1400000US06037602505,6037602505,2022,770,545,70.779999,523,22
1400000US06037602506,6037602506,2022,683,490,71.739998,473,17
1400000US06037602511,6037602511,2022,1491,1120,75.120003,1072,48
1400000US06037602601,6037602601,2022,352,326,92.610001,313,13
1400000US06037602700,6037602700,2022,231,198,85.709999,190,8
1400000US06037602801,6037602801,2022,1014,975,96.150002,900,75
1400000US06037602802,6037602802,2022,900,829,92.110001,769,60
1400000US06037603006,6037603006,2022,360,318,88.330002,298,20
1400000US06037603008,6037603008,2022,651,587,90.169998,538,49
1400000US06037603200,6037603200,2022,1442,1339,92.860001,1253,86
1400000US06037603301,6037603301,2022,1795,1504,83.790001,1384,120
1400000US06037603400,6037603400,2022,668,474,70.959999,402,72
1400000US06037603600,6037603600,2022,114,95,83.330002,89,6
1400000US06037603702,6037603702,2022,563,382,67.849998,316,66
1400000US06037603705,6037603705,2022,97,79,81.440002,79,0
1400000US06037603706,6037603706,2022,478,407,85.150002,366,41
1400000US06037603801,6037603801,2022,1790,1416,79.110001,1333,83
1400000US06037603802,6037603802,2022,1432,1249,87.220001,1109,140
1400000US06037603901,6037603901,2022,2843,2260,79.489998,2009,251
1400000US06037603902,6037603902,2022,795,695,87.419998,601,94
1400000US06037604001,6037604001,2022,500,382,76.400002,345,37
1400000US06037604002,6037604002,2022,571,513,89.839996,441,72
1400000US06037604200,6037604200,2022,774,662,85.529999,587,75
1400000US06037620001,6037620001,2022,729,62,8.5,61,1
1400000US06037620002,6037620002,2022,794,75,9.4499998,73,2
1400000US06037620101,6037620101,2022,1858,235,12.65,227,8
1400000US06037620303,6037620303,2022,518,13,2.51,13,0
1400000US06037620305,6037620305,2022,488,10,2.05,10,0
1400000US06037620400,6037620400,2022,1646,81,4.9200001,78,3
1400000US06037620501,6037620501,2022,595,72,12.1,69,3
1400000US06037620521,6037620521,2022,416,62,14.9,61,1
1400000US06037620602,6037620602,2022,1876,326,17.379999,295,31
1400000US06037620701,6037620701,2022,461,41,8.8900003,39,2
1400000US06037620703,6037620703,2022,509,33,6.48,33,0
1400000US06037620802,6037620802,2022,2789,143,5.1300001,141,2
1400000US06037620904,6037620904,2022,261,8,3.0699999,8,0
1400000US06037621005,6037621005,2022,1201,93,7.7399998,92,1
1400000US06037621201,6037621201,2022,4560,659,14.45,619,40
1400000US06037621301,6037621301,2022,562,63,11.21,62,1
1400000US06037621400,6037621400,2022,420,44,10.48,44,0
1400000US06037650001,6037650001,2022,1044,330,31.610001,285,45
1400000US06037650004,6037650004,2022,344,204,59.299999,174,30
1400000US06037650101,6037650101,2022,525,186,35.43,150,36
1400000US06037650200,6037650200,2022,2495,929,37.23,803,126
1400000US06037650300,6037650300,2022,528,246,46.59,219,27
1400000US06037650401,6037650401,2022,1139,267,23.440001,247,20
1400000US06037650502,6037650502,2022,1138,170,14.94,158,12
1400000US06037650603,6037650603,2022,2789,603,21.620001,550,53
1400000US06037650701,6037650701,2022,669,144,21.52,131,13
1400000US06037650702,6037650702,2022,568,49,8.6300001,45,4
1400000US06037650903,6037650903,2022,1916,526,27.450001,483,43
1400000US06037650904,6037650904,2022,562,314,55.869999,282,32
1400000US06037651001,6037651001,2022,636,246,38.68,230,16
1400000US06037651002,6037651002,2022,769,238,30.950001,217,21
1400000US06037651101,6037651101,2022,849,154,18.139999,126,28
1400000US06037651201,6037651201,2022,483,60,12.42,52,8
1400000US06037651221,6037651221,2022,610,117,19.18,109,8
1400000US06037651222,6037651222,2022,2561,443,17.299999,395,48
1400000US06037651302,6037651302,2022,1225,154,12.57,147,7
1400000US06037651402,6037651402,2022,605,77,12.73,74,3
1400000US06037670002,6037670002,2022,1096,975,88.959999,923,52
1400000US06037670003,6037670003,2022,796,543,68.220001,485,58
1400000US06037670101,6037670101,2022,406,359,88.419998,347,12
1400000US06037670202,6037670202,2022,312,39,12.5,39,0
1400000US06037670324,6037670324,2022,627,36,5.7399998,36,0
1400000US06037670326,6037670326,2022,394,15,3.8099999,13,2
1400000US06037670328,6037670328,2022,2370,140,5.9099998,137,3
1400000US06037670405,6037670405,2022,878,86,9.79,84,2
1400000US06037670413,6037670413,2022,369,21,5.6900001,21,0
1400000US06037670416,6037670416,2022,322,32,9.9399996,29,3
1400000US06037670417,6037670417,2022,2666,224,8.3999996,220,4
1400000US06037670418,6037670418,2022,905,50,5.52,45,5
1400000US06037670500,6037670500,2022,169,17,10.06,17,0
1400000US06037670604,6037670604,2022,349,19,5.4400001,18,1
1400000US06037670701,6037670701,2022,1682,993,59.040001,828,165
1400000US06037670702,6037670702,2022,799,71,8.8900003,67,4
1400000US06037700200,6037700200,2022,1799,770,42.799999,703,67
1400000US06037700400,6037700400,2022,262,154,58.779999,143,11
1400000US06037700501,6037700501,2022,306,81,26.469999,70,11
1400000US06037700600,6037700600,2022,495,49,9.8999996,48,1
1400000US06037700901,6037700901,2022,566,91,16.08,90,1
1400000US06037700902,6037700902,2022,818,128,15.65,125,3
1400000US06037701000,6037701000,2022,1199,204,17.01,203,1
1400000US06037701304,6037701304,2022,574,84,14.63,81,3
1400000US06037701501,6037701501,2022,908,174,19.16,165,9
1400000US06037701601,6037701601,2022,561,32,5.6999998,32,0
1400000US06037701602,6037701602,2022,366,105,28.690001,91,14
1400000US06037701801,6037701801,2022,381,117,30.709999,111,6
1400000US06037701902,6037701902,2022,2714,726,26.75,678,48
1400000US06037702002,6037702002,2022,603,162,26.870001,156,6
1400000US06037702201,6037702201,2022,1244,388,31.190001,360,28
1400000US06037702300,6037702300,2022,530,132,24.91,119,13
1400000US06037702400,6037702400,2022,541,182,33.639999,138,44
1400000US06037702600,6037702600,2022,1368,344,25.15,207,137
1400000US06037702700,6037702700,2022,4316,1729,40.060001,1266,463
1400000US06037702801,6037702801,2022,544,306,56.25,260,46
1400000US06037702803,6037702803,2022,504,290,57.540001,266,24
1400000US06037703002,6037703002,2022,339,240,70.800003,217,23
1400000US06037703100,6037703100,2022,346,285,82.370003,281,4
1400000US06037703200,6037703200,2022,267,243,91.010002,242,1
1400000US06037800101,6037800101,2022,3100,422,13.61,337,85
1400000US06037800103,6037800103,2022,186,31,16.67,30,1
1400000US06037800202,6037800202,2022,1118,159,14.22,123,36
1400000US06037800205,6037800205,2022,460,97,21.09,82,15
1400000US06037800206,6037800206,2022,502,48,9.5600004,33,15
1400000US06037800325,6037800325,2022,357,33,9.2399998,25,8
1400000US06037800334,6037800334,2022,2446,403,16.48,344,59
1400000US06037800337,6037800337,2022,137,20,14.6,20,0
1400000US06037800338,6037800338,2022,1724,250,14.5,193,57
1400000US06037800406,6037800406,2022,17,17,100,17,0
1400000US06037800411,6037800411,2022,661,100,15.13,97,3
1400000US06037800412,6037800412,2022,207,32,15.46,32,0
1400000US06037800504,6037800504,2022,199,24,12.06,24,0
1400000US06037900102,6037900102,2022,647,626,96.75,583,43
1400000US06037900103,6037900103,2022,560,543,96.959999,501,42
1400000US06037900104,6037900104,2022,487,416,85.419998,370,46
1400000US06037900301,6037900301,2022,669,593,88.639999,561,32
1400000US06037900501,6037900501,2022,462,434,93.940002,393,41
1400000US06037900504,6037900504,2022,4086,3309,80.980003,2995,314
1400000US06037900505,6037900505,2022,610,556,91.150002,493,63
1400000US06037900508,6037900508,2022,2626,1918,73.040001,1766,152
1400000US06037900510,6037900510,2022,1322,1138,86.080002,1056,82
1400000US06037900602,6037900602,2022,721,690,95.699997,631,59
1400000US06037900606,6037900606,2022,2666,2264,84.919998,2122,142
1400000US06037900607,6037900607,2022,699,661,94.559998,612,49
1400000US06037900609,6037900609,2022,643,597,92.849998,516,81
1400000US06037900610,6037900610,2022,671,570,84.949997,513,57
1400000US06037900701,6037900701,2022,966,853,88.300003,782,71
1400000US06037900703,6037900703,2022,2183,1958,89.690002,1777,181
1400000US06037900804,6037900804,2022,607,569,93.739998,509,60
1400000US06037900805,6037900805,2022,700,625,89.290001,534,91
1400000US06037900807,6037900807,2022,621,573,92.269997,508,65
1400000US06037900901,6037900901,2022,704,388,55.110001,276,112
1400000US06037901007,6037901007,2022,717,463,64.57,390,73
1400000US06037901009,6037901009,2022,883,764,86.519997,629,135
1400000US06037901010,6037901010,2022,634,516,81.389999,411,105
1400000US06037901011,6037901011,2022,656,546,83.230003,472,74
1400000US06037901012,6037901012,2022,740,604,81.620003,474,130
1400000US06037901013,6037901013,2022,1152,763,66.230003,585,178
1400000US06037901014,6037901014,2022,2622,1439,54.880001,1387,52
1400000US06037901101,6037901101,2022,902,493,54.66,394,99
1400000US06037901209,6037901209,2022,300,204,68,177,27
1400000US06037901214,6037901214,2022,825,484,58.669998,357,127
1400000US06037901215,6037901215,2022,3562,1431,40.169998,1259,172
1400000US06037901217,6037901217,2022,326,211,64.720001,162,49
1400000US06037901300,6037901300,2022,392,371,94.639999,347,24
1400000US06037910002,6037910002,2022,212,168,79.25,136,32
1400000US06037910210,6037910210,2022,916,534,58.299999,406,128
1400000US06037910212,6037910212,2022,802,221,27.559999,153,68
1400000US06037910214,6037910214,2022,4158,2536,60.990002,2293,243
1400000US06037910215,6037910215,2022,1508,1237,82.029999,1037,200
1400000US06037910217,6037910217,2022,646,403,62.380001,294,109
1400000US06037910218,6037910218,2022,538,383,71.190002,364,19
1400000US06037910301,6037910301,2022,785,532,67.769997,427,105
1400000US06037910302,6037910302,2022,1701,907,53.32,695,212
1400000US06037910401,6037910401,2022,581,447,76.940002,386,61
1400000US06037910404,6037910404,2022,490,454,92.650002,415,39
1400000US06037910405,6037910405,2022,1203,1052,87.449997,959,93
1400000US06037910504,6037910504,2022,583,572,98.110001,553,19
1400000US06037910601,6037910601,2022,613,571,93.150002,530,41
1400000US06037910602,6037910602,2022,5466,4133,75.610001,3718,415
1400000US06037910605,6037910605,2022,1139,1054,92.540001,907,147
1400000US06037910606,6037910606,2022,1095,972,88.769997,880,92
1400000US06037910608,6037910608,2022,602,585,97.18,528,57
1400000US06037910706,6037910706,2022,616,555,90.099998,463,92
1400000US06037910712,6037910712,2022,486,403,82.919998,353,50
1400000US06037910714,6037910714,2022,1256,1114,88.690002,996,118
1400000US06037910715,6037910715,2022,532,501,94.169998,449,52
1400000US06037910716,6037910716,2022,1495,1333,89.160004,1160,173
1400000US06037910717,6037910717,2022,4223,2646,62.66,2344,302
1400000US06037910718,6037910718,2022,1374,1290,93.889999,1123,167
1400000US06037910720,6037910720,2022,636,585,91.980003,519,66
1400000US06037910804,6037910804,2022,4049,1519,37.52,1352,167
1400000US06037910807,6037910807,2022,1177,684,58.110001,527,157
1400000US06037910814,6037910814,2022,329,122,37.080002,120,2
1400000US06037910815,6037910815,2022,1149,712,61.970001,633,79
1400000US06037911001,6037911001,2022,906,701,77.370003,646,55
1400000US06037911100,6037911100,2022,2417,1958,81.010002,1749,209
1400000US06037920013,6037920013,2022,725,111,15.31,85,26
1400000US06037920015,6037920015,2022,840,161,19.17,94,67
1400000US06037920017,6037920017,2022,1402,355,25.32,271,84
1400000US06037920020,6037920020,2022,648,178,27.469999,132,46
1400000US06037920029,6037920029,2022,2471,928,37.560001,820,108
1400000US06037920031,6037920031,2022,3083,1250,40.540001,1190,60
1400000US06037920034,6037920034,2022,959,590,61.52,430,160
1400000US06037920035,6037920035,2022,514,371,72.18,305,66
1400000US06037920041,6037920041,2022,1832,763,41.650002,628,135
1400000US06037920042,6037920042,2022,528,355,67.230003,298,57
1400000US06037920043,6037920043,2022,1364,507,37.169998,348,159
1400000US06037920044,6037920044,2022,2423,325,13.41,311,14
1400000US06037920048,6037920048,2022,1879,920,48.959999,826,94
1400000US06037920049,6037920049,2022,703,150,21.34,91,59
1400000US06037920102,6037920102,2022,705,369,52.34,288,81
1400000US06037920104,6037920104,2022,1020,258,25.290001,235,23
1400000US06037920109,6037920109,2022,463,53,11.45,45,8
1400000US06037920111,6037920111,2022,331,170,51.360001,122,48
1400000US06037920112,6037920112,2022,1181,164,13.89,154,10
1400000US06037920115,6037920115,2022,1159,248,21.4,180,68
1400000US06037920118,6037920118,2022,1698,624,36.75,513,111
1400000US06037920119,6037920119,2022,426,116,27.23,62,54
1400000US06037920120,6037920120,2022,486,84,17.280001,69,15
1400000US06037920121,6037920121,2022,4771,731,15.32,633,98
1400000US06037920313,6037920313,2022,876,591,67.470001,498,93
1400000US06037920314,6037920314,2022,683,228,33.380001,224,4
1400000US06037920322,6037920322,2022,518,205,39.580002,156,49
1400000US06037920326,6037920326,2022,780,219,28.08,138,81
1400000US06037920329,6037920329,2022,820,281,34.27,187,94
1400000US06037920330,6037920330,2022,394,53,13.45,47,6
1400000US06037920334,6037920334,2022,648,213,32.869999,111,102
1400000US06037920338,6037920338,2022,692,122,17.629999,67,55
1400000US06037920339,6037920339,2022,3277,472,14.4,409,63
1400000US06037920340,6037920340,2022,2986,1152,38.580002,1116,36
1400000US06037920341,6037920341,2022,566,471,83.220001,443,28
1400000US06037920342,6037920342,2022,519,412,79.379997,352,60
1400000US06037930400,6037930400,2022,82,29,35.369999,29,0
1400000US06037980004,6037980004,2022,718,687,95.68,654,33
1400000US06037980013,6037980013,2022,1184,494,41.720001,402,92
1400000US06037980016,6037980016,2022,173,166,95.949997,162,4
1400000US06037980035,6037980035,2022,3,2,66.669998,2,0
1400000US06037101110,6037101110,2021,1233,917,74.370003,785,132
1400000US06037101220,6037101220,2021,182,171,93.959999,161,10
1400000US06037101300,6037101300,2021,472,332,70.339996,263,69
1400000US06037102107,6037102107,2021,901,682,75.690002,565,117
1400000US06037103101,6037103101,2021,824,691,83.860001,631,60
1400000US06037103102,6037103102,2021,606,493,81.349998,457,36
1400000US06037103202,6037103202,2021,148,117,79.050003,104,13
1400000US06037103402,6037103402,2021,388,221,56.959999,202,19
1400000US06037104103,6037104103,2021,612,493,80.559998,422,71
1400000US06037104105,6037104105,2021,877,703,80.160004,635,68
1400000US06037104108,6037104108,2021,1090,1040,95.410004,1001,39
1400000US06037104124,6037104124,2021,1131,1053,93.099998,885,168
1400000US06037104204,6037104204,2021,406,398,98.029999,386,12
1400000US06037104310,6037104310,2021,3056,2969,97.150002,2626,343
1400000US06037104321,6037104321,2021,1076,768,71.379997,749,19
1400000US06037104401,6037104401,2021,630,595,94.440002,571,24
1400000US06037104500,6037104500,2021,685,624,91.089996,588,36
1400000US06037104821,6037104821,2021,807,700,86.739998,607,93
1400000US06037104822,6037104822,2021,1034,949,91.779999,894,55
1400000US06037106020,6037106020,2021,222,154,69.370003,140,14
1400000US06037106112,6037106112,2021,565,490,86.730003,446,44
1400000US06037106113,6037106113,2021,378,247,65.339996,219,28
1400000US06037106114,6037106114,2021,410,346,84.389999,311,35
1400000US06037106403,6037106403,2021,2103,1890,89.870003,1758,132
1400000US06037106405,6037106405,2021,2438,2153,88.309998,1993,160
1400000US06037106510,6037106510,2021,94,94,100,94,0
1400000US06037106520,6037106520,2021,1654,1532,92.620003,1347,185
1400000US06037106603,6037106603,2021,416,194,46.630001,161,33
1400000US06037106604,6037106604,2021,372,335,90.050003,319,16
1400000US06037106641,6037106641,2021,1508,802,53.18,676,126
1400000US06037106642,6037106642,2021,412,122,29.610001,111,11
1400000US06037106646,6037106646,2021,2783,1916,68.849998,1660,256
1400000US06037106648,6037106648,2021,338,299,88.459999,278,21
1400000US06037107020,6037107020,2021,634,580,91.480003,551,29
1400000US06037108104,6037108104,2021,644,117,18.17,107,10
1400000US06037108202,6037108202,2021,1200,230,19.17,211,19
1400000US06037109200,6037109200,2021,301,214,71.099998,181,33
1400000US06037109300,6037109300,2021,555,396,71.349998,325,71
1400000US06037109500,6037109500,2021,2047,1904,93.010002,1783,121
1400000US06037109601,6037109601,2021,632,434,68.669998,379,55
1400000US06037109700,6037109700,2021,1221,833,68.220001,715,118
1400000US06037109800,6037109800,2021,774,453,58.529999,367,86
1400000US06037111100,6037111100,2021,439,299,68.110001,263,36
1400000US06037111202,6037111202,2021,379,259,68.339996,228,31
1400000US06037111204,6037111204,2021,2803,1242,44.310001,1054,188
1400000US06037111206,6037111206,2021,424,223,52.59,190,33
1400000US06037111302,6037111302,2021,426,285,66.900002,270,15
1400000US06037111303,6037111303,2021,2168,1470,67.800003,1217,253
1400000US06037111304,6037111304,2021,5377,2592,48.209999,2041,551
1400000US06037111401,6037111401,2021,474,317,66.879997,276,41
1400000US06037113101,6037113101,2021,505,326,64.550003,288,38
1400000US06037113212,6037113212,2021,446,279,62.560001,247,32
1400000US06037113232,6037113232,2021,337,293,86.940002,280,13
1400000US06037113303,6037113303,2021,569,363,63.799999,326,37
1400000US06037113322,6037113322,2021,429,120,27.969999,99,21
1400000US06037113323,6037113323,2021,1336,815,61,750,65
1400000US06037113324,6037113324,2021,1623,1095,67.470001,990,105
1400000US06037113423,6037113423,2021,131,65,49.619999,65,0
1400000US06037113428,6037113428,2021,703,650,92.459999,624,26
1400000US06037115101,6037115101,2021,2415,1305,54.040001,1152,153
1400000US06037115103,6037115103,2021,943,691,73.279999,620,71
1400000US06037115202,6037115202,2021,474,318,67.089996,280,38
1400000US06037115301,6037115301,2021,530,201,37.919998,173,28
1400000US06037115302,6037115302,2021,399,374,93.730003,366,8
1400000US06037115401,6037115401,2021,766,706,92.169998,666,40
1400000US06037115403,6037115403,2021,289,217,75.089996,169,48
1400000US06037115404,6037115404,2021,227,54,23.790001,53,1
1400000US06037117101,6037117101,2021,2793,2652,94.949997,2520,132
1400000US06037117102,6037117102,2021,437,399,91.300003,374,25
1400000US06037117202,6037117202,2021,2197,1990,90.580002,1902,88
1400000US06037117302,6037117302,2021,465,433,93.120003,399,34
1400000US06037117303,6037117303,2021,276,106,38.41,96,10
1400000US06037117407,6037117407,2021,569,563,98.949997,554,9
1400000US06037117510,6037117510,2021,511,486,95.110001,426,60
1400000US06037117520,6037117520,2021,558,549,98.389999,541,8
1400000US06037117530,6037117530,2021,736,713,96.879997,688,25
1400000US06037119003,6037119003,2021,497,457,91.949997,439,18
1400000US06037119004,6037119004,2021,519,450,86.709999,391,59
1400000US06037119201,6037119201,2021,1662,1520,91.459999,1422,98
1400000US06037119342,6037119342,2021,566,523,92.400002,499,24
1400000US06037119802,6037119802,2021,681,590,86.639999,531,59
1400000US06037119900,6037119900,2021,882,812,92.059998,726,86
1400000US06037120010,6037120010,2021,1237,1221,98.709999,1194,27
1400000US06037120020,6037120020,2021,615,599,97.400002,583,16
1400000US06037120030,6037120030,2021,1620,1564,96.540001,1510,54
1400000US06037120107,6037120107,2021,467,454,97.220001,447,7
1400000US06037120108,6037120108,2021,864,844,97.690002,822,22
1400000US06037120300,6037120300,2021,286,262,91.610001,254,8
1400000US06037120400,6037120400,2021,420,375,89.290001,354,21
1400000US06037121010,6037121010,2021,3721,3447,92.639999,3176,271
1400000US06037121020,6037121020,2021,489,448,91.620003,401,47
1400000US06037121102,6037121102,2021,291,212,72.849998,199,13
1400000US06037121210,6037121210,2021,348,295,84.769997,272,23
1400000US06037121222,6037121222,2021,2463,2323,94.32,2184,139
1400000US06037121600,6037121600,2021,62,52,83.870003,48,4
1400000US06037121801,6037121801,2021,333,316,94.889999,304,12
1400000US06037121900,6037121900,2021,376,350,93.089996,332,18
1400000US06037122000,6037122000,2021,511,467,91.389999,446,21
1400000US06037122122,6037122122,2021,504,478,94.839996,448,30
1400000US06037122200,6037122200,2021,206,187,90.779999,178,9
1400000US06037122420,6037122420,2021,457,436,95.400002,419,17
1400000US06037123010,6037123010,2021,1675,1604,95.760002,1519,85
1400000US06037123301,6037123301,2021,422,408,96.68,388,20
1400000US06037123303,6037123303,2021,582,551,94.669998,523,28
1400000US06037123420,6037123420,2021,1590,1478,92.959999,1418,60
1400000US06037123510,6037123510,2021,694,645,92.940002,628,17
1400000US06037123601,6037123601,2021,1903,1782,93.639999,1664,118
1400000US06037123602,6037123602,2021,606,552,91.089996,520,32
1400000US06037123700,6037123700,2021,665,519,78.050003,463,56
1400000US06037123901,6037123901,2021,1804,1694,93.900002,1598,96
1400000US06037124102,6037124102,2021,671,619,92.25,577,42
1400000US06037124201,6037124201,2021,654,627,95.870003,591,36
1400000US06037124300,6037124300,2021,328,308,93.900002,296,12
1400000US06037124600,6037124600,2021,1643,880,53.560001,774,106
1400000US06037124700,6037124700,2021,459,155,33.77,151,4
1400000US06037124902,6037124902,2021,322,239,74.220001,215,24
1400000US06037125101,6037125101,2021,2622,1809,68.989998,1655,154
1400000US06037125102,6037125102,2021,624,169,27.08,152,17
1400000US06037125310,6037125310,2021,869,578,66.510002,548,30
1400000US06037125322,6037125322,2021,325,294,90.459999,284,10
1400000US06037125600,6037125600,2021,460,314,68.260002,293,21
1400000US06037127210,6037127210,2021,2565,2385,92.980003,2252,133
1400000US06037127400,6037127400,2021,446,411,92.150002,398,13
1400000US06037127603,6037127603,2021,573,559,97.559998,537,22
1400000US06037127803,6037127803,2021,289,175,60.549999,161,14
1400000US06037127805,6037127805,2021,419,401,95.699997,386,15
1400000US06037127806,6037127806,2021,2571,2205,85.760002,2047,158
1400000US06037127910,6037127910,2021,1023,763,74.580002,697,66
1400000US06037127920,6037127920,2021,690,649,94.059998,611,38
1400000US06037128102,6037128102,2021,808,743,91.959999,704,39
1400000US06037128302,6037128302,2021,705,678,96.169998,649,29
1400000US06037128602,6037128602,2021,425,208,48.939999,193,15
1400000US06037128802,6037128802,2021,2092,1436,68.639999,1312,124
1400000US06037128910,6037128910,2021,167,91,54.490002,84,7
1400000US06037131022,6037131022,2021,328,314,95.730003,302,12
1400000US06037131023,6037131023,2021,378,333,88.099998,309,24
1400000US06037131100,6037131100,2021,410,287,70,267,20
1400000US06037131200,6037131200,2021,459,326,71.019997,292,34
1400000US06037131300,6037131300,2021,374,363,97.059998,354,9
1400000US06037131600,6037131600,2021,3197,2123,66.410004,1934,189
1400000US06037131701,6037131701,2021,55,29,52.73,25,4
1400000US06037131801,6037131801,2021,1014,902,88.949997,801,101
1400000US06037131900,6037131900,2021,340,304,89.410004,279,25
1400000US06037132001,6037132001,2021,384,315,82.029999,286,29
1400000US06037132002,6037132002,2021,6383,5266,82.5,4708,558
1400000US06037132301,6037132301,2021,317,279,88.010002,259,20
1400000US06037132501,6037132501,2021,7,5,71.43,5,0
1400000US06037132700,6037132700,2021,1931,1683,87.160004,1577,106
1400000US06037133000,6037133000,2021,518,361,69.690002,330,31
1400000US06037133101,6037133101,2021,419,376,89.739998,362,14
1400000US06037133102,6037133102,2021,2085,1143,54.82,963,180
1400000US06037134001,6037134001,2021,658,640,97.260002,629,11
1400000US06037134002,6037134002,2021,470,265,56.380001,248,17
1400000US06037134101,6037134101,2021,391,356,91.050003,335,21
1400000US06037134103,6037134103,2021,479,445,92.900002,432,13
1400000US06037134104,6037134104,2021,418,388,92.82,341,47
1400000US06037134302,6037134302,2021,414,315,76.089996,281,34
1400000US06037134303,6037134303,2021,556,538,96.760002,522,16
1400000US06037134304,6037134304,2021,1093,976,89.300003,922,54
1400000US06037134421,6037134421,2021,562,170,30.25,159,11
1400000US06037134422,6037134422,2021,234,158,67.519997,129,29
1400000US06037134423,6037134423,2021,391,162,41.43,137,25
1400000US06037134520,6037134520,2021,1416,1252,88.419998,1196,56
1400000US06037134522,6037134522,2021,683,598,87.550003,578,20
1400000US06037134720,6037134720,2021,1586,1407,88.709999,1319,88
1400000US06037134801,6037134801,2021,403,361,89.580002,337,24
1400000US06037135102,6037135102,2021,295,154,52.200001,130,24
1400000US06037135202,6037135202,2021,765,152,19.870001,133,19
1400000US06037135204,6037135204,2021,874,251,28.719999,229,22
1400000US06037137000,6037137000,2021,3566,1151,32.279999,1017,134
1400000US06037137104,6037137104,2021,608,472,77.629997,456,16
1400000US06037137203,6037137203,2021,595,410,68.910004,367,43
1400000US06037137301,6037137301,2021,512,165,32.23,157,8
1400000US06037137302,6037137302,2021,2018,769,38.110001,666,103
1400000US06037137401,6037137401,2021,649,161,24.809999,137,24
1400000US06037137402,6037137402,2021,410,122,29.76,104,18
1400000US06037137501,6037137501,2021,2966,1654,55.77,1448,206
1400000US06037139001,6037139001,2021,307,100,32.57,80,20
1400000US06037139200,6037139200,2021,277,168,60.650002,150,18
1400000US06037139301,6037139301,2021,596,420,70.470001,374,46
1400000US06037139402,6037139402,2021,2983,1158,38.82,1034,124
1400000US06037139502,6037139502,2021,463,263,56.799999,253,10
1400000US06037139600,6037139600,2021,542,150,27.68,142,8
1400000US06037139701,6037139701,2021,542,42,7.75,35,7
1400000US06037141101,6037141101,2021,702,195,27.780001,186,9
1400000US06037141304,6037141304,2021,643,195,30.33,188,7
1400000US06037141400,6037141400,2021,532,94,17.67,90,4
1400000US06037143200,6037143200,2021,724,440,60.77,404,36
1400000US06037143302,6037143302,2021,1599,863,53.970001,794,69
1400000US06037143700,6037143700,2021,215,57,26.51,53,4
1400000US06037143801,6037143801,2021,874,112,12.81,107,5
1400000US06037181000,6037181000,2021,460,429,93.260002,396,33
1400000US06037181400,6037181400,2021,765,333,43.529999,265,68
1400000US06037181500,6037181500,2021,839,358,42.669998,320,38
1400000US06037181600,6037181600,2021,2196,1184,53.919998,991,193
1400000US06037183101,6037183101,2021,1306,1110,84.989998,1034,76
1400000US06037183104,6037183104,2021,269,200,74.349998,169,31
1400000US06037183220,6037183220,2021,220,186,84.550003,171,15
1400000US06037183401,6037183401,2021,280,234,83.57,212,22
1400000US06037183402,6037183402,2021,272,228,83.82,211,17
1400000US06037183510,6037183510,2021,1463,1309,89.470001,1190,119
1400000US06037183520,6037183520,2021,269,245,91.080002,230,15
1400000US06037183702,6037183702,2021,167,146,87.43,133,13
1400000US06037183810,6037183810,2021,403,373,92.559998,351,22
1400000US06037185101,6037185101,2021,489,380,77.709999,356,24
1400000US06037185102,6037185102,2021,405,320,79.010002,294,26
1400000US06037185204,6037185204,2021,433,66,15.24,62,4
1400000US06037185310,6037185310,2021,1079,984,91.199997,936,48
1400000US06037186100,6037186100,2021,459,248,54.029999,198,50
1400000US06037186401,6037186401,2021,1780,1569,88.150002,1414,155
1400000US06037186404,6037186404,2021,269,251,93.309998,236,15
1400000US06037187101,6037187101,2021,298,183,61.41,173,10
1400000US06037187102,6037187102,2021,1329,828,62.299999,698,130
1400000US06037187300,6037187300,2021,326,260,79.75,225,35
1400000US06037188201,6037188201,2021,439,61,13.9,56,5
1400000US06037188300,6037188300,2021,214,146,68.220001,120,26
1400000US06037189201,6037189201,2021,436,375,86.010002,352,23
1400000US06037189501,6037189501,2021,225,158,70.220001,154,4
1400000US06037189905,6037189905,2021,299,153,51.169998,144,9
1400000US06037190102,6037190102,2021,1304,1199,91.949997,1166,33
1400000US06037190510,6037190510,2021,437,421,96.339996,401,20
1400000US06037190701,6037190701,2021,80,73,91.25,72,1
1400000US06037190901,6037190901,2021,1269,1228,96.769997,1167,61
1400000US06037190902,6037190902,2021,857,825,96.269997,797,28
1400000US06037191120,6037191120,2021,349,337,96.559998,324,13
1400000US06037191204,6037191204,2021,373,354,94.910004,343,11
1400000US06037191301,6037191301,2021,98,87,88.779999,82,5
1400000US06037191410,6037191410,2021,371,364,98.110001,346,18
1400000US06037191720,6037191720,2021,843,786,93.239998,729,57
1400000US06037191810,6037191810,2021,302,282,93.379997,272,10
1400000US06037191901,6037191901,2021,549,504,91.800003,476,28
1400000US06037192001,6037192001,2021,458,223,48.689999,184,39
1400000US06037192002,6037192002,2021,1840,1446,78.589996,1312,134
1400000US06037192410,6037192410,2021,183,164,89.620003,153,11
1400000US06037192520,6037192520,2021,306,287,93.790001,275,12
1400000US06037192620,6037192620,2021,505,481,95.25,462,19
1400000US06037192700,6037192700,2021,316,295,93.349998,284,11
1400000US06037194300,6037194300,2021,458,83,18.120001,79,4
1400000US06037195201,6037195201,2021,2594,1658,63.919998,1511,147
1400000US06037195300,6037195300,2021,1976,1405,71.099998,1281,124
1400000US06037195400,6037195400,2021,381,159,41.73,147,12
1400000US06037195500,6037195500,2021,175,151,86.290001,136,15
1400000US06037195710,6037195710,2021,810,657,81.110001,633,24
1400000US06037197200,6037197200,2021,251,198,78.879997,177,21
1400000US06037197300,6037197300,2021,340,210,61.759998,188,22
1400000US06037197410,6037197410,2021,124,83,66.940002,77,6
1400000US06037197420,6037197420,2021,823,711,86.389999,650,61
1400000US06037199001,6037199001,2021,111,20,18.02,20,0
1400000US06037199002,6037199002,2021,289,277,95.849998,269,8
1400000US06037199120,6037199120,2021,375,336,89.599998,304,32
1400000US06037199201,6037199201,2021,319,315,98.75,315,0
1400000US06037199202,6037199202,2021,1267,1215,95.900002,1158,57
1400000US06037199300,6037199300,2021,585,456,77.949997,441,15
1400000US06037199400,6037199400,2021,105,98,93.330002,97,1
1400000US06037199700,6037199700,2021,1360,1258,92.5,1179,79
1400000US06037199801,6037199801,2021,358,338,94.410004,311,27
1400000US06037199802,6037199802,2021,548,517,94.339996,495,22
1400000US06037201110,6037201110,2021,1021,252,24.68,210,42
1400000US06037201120,6037201120,2021,173,149,86.129997,131,18
1400000US06037201200,6037201200,2021,298,279,93.620003,263,16
1400000US06037201301,6037201301,2021,281,265,94.309998,254,11
1400000US06037201302,6037201302,2021,57,29,50.880001,29,0
1400000US06037201401,6037201401,2021,1706,1507,88.339996,1400,107
1400000US06037201402,6037201402,2021,1728,1567,90.68,1483,84
1400000US06037201501,6037201501,2021,225,213,94.669998,212,1
1400000US06037201602,6037201602,2021,322,294,91.300003,271,23
1400000US06037201700,6037201700,2021,542,111,20.48,86,25
1400000US06037203100,6037203100,2021,349,331,94.839996,323,8
1400000US06037203200,6037203200,2021,575,550,95.650002,538,12
1400000US06037203300,6037203300,2021,1871,1647,88.029999,1514,133
1400000US06037203500,6037203500,2021,174,171,98.279999,164,7
1400000US06037203601,6037203601,2021,623,604,96.949997,592,12
1400000US06037203800,6037203800,2021,467,439,94,429,10
1400000US06037204110,6037204110,2021,550,463,84.18,342,121
1400000US06037204300,6037204300,2021,2425,2333,96.209999,2274,59
1400000US06037204410,6037204410,2021,227,212,93.389999,208,4
1400000US06037204420,6037204420,2021,770,725,94.160004,709,16
1400000US06037204700,6037204700,2021,2239,2141,95.620003,1933,208
1400000US06037204810,6037204810,2021,1510,1391,92.120003,1342,49
1400000US06037204820,6037204820,2021,594,564,94.949997,512,52
1400000US06037204910,6037204910,2021,1181,1122,95,1074,48
1400000US06037205110,6037205110,2021,1031,963,93.400002,892,71
1400000US06037205120,6037205120,2021,83,79,95.18,77,2
1400000US06037206010,6037206010,2021,304,210,69.080002,193,17
1400000US06037206050,6037206050,2021,187,150,80.209999,136,14
1400000US06037206051,6037206051,2021,344,288,83.720001,270,18
1400000US06037206054,6037206054,2021,1336,1270,95.059998,1217,53
1400000US06037207101,6037207101,2021,1132,775,68.459999,716,59
1400000US06037207103,6037207103,2021,601,493,82.029999,466,27
1400000US06037207400,6037207400,2021,335,290,86.57,267,23
1400000US06037207502,6037207502,2021,409,335,81.910004,307,28
1400000US06037207712,6037207712,2021,126,119,94.440002,103,16
1400000US06037208001,6037208001,2021,2761,2519,91.239998,2388,131
1400000US06037208002,6037208002,2021,499,470,94.190002,441,29
1400000US06037208302,6037208302,2021,1339,1301,97.160004,1268,33
1400000US06037208401,6037208401,2021,947,935,98.730003,922,13
1400000US06037208501,6037208501,2021,1004,533,53.09,481,52
1400000US06037208610,6037208610,2021,421,394,93.589996,374,20
1400000US06037208710,6037208710,2021,64,60,93.75,59,1
1400000US06037208720,6037208720,2021,494,434,87.849998,358,76
1400000US06037208801,6037208801,2021,450,445,98.889999,443,2
1400000US06037208802,6037208802,2021,630,613,97.300003,589,24
1400000US06037208902,6037208902,2021,1254,1251,99.760002,1245,6
1400000US06037209103,6037209103,2021,653,617,94.489998,609,8
1400000US06037209104,6037209104,2021,408,407,99.75,407,0
1400000US06037209106,6037209106,2021,963,961,99.790001,956,5
1400000US06037209202,6037209202,2021,1089,1077,98.900002,1062,15
1400000US06037209520,6037209520,2021,533,497,93.25,457,40
1400000US06037209820,6037209820,2021,461,429,93.059998,408,21
1400000US06037210010,6037210010,2021,560,547,97.68,538,9
1400000US06037211000,6037211000,2021,1581,1352,85.519997,1256,96
1400000US06037211121,6037211121,2021,966,870,90.059998,827,43
1400000US06037211122,6037211122,2021,2253,2126,94.360001,2039,87
1400000US06037211123,6037211123,2021,980,956,97.550003,931,25
1400000US06037211124,6037211124,2021,682,545,79.910004,513,32
1400000US06037211202,6037211202,2021,567,553,97.529999,535,18
1400000US06037211410,6037211410,2021,547,532,97.260002,501,31
1400000US06037211420,6037211420,2021,375,329,87.730003,308,21
1400000US06037212202,6037212202,2021,608,601,98.849998,591,10
1400000US06037212204,6037212204,2021,796,736,92.459999,667,69
1400000US06037212303,6037212303,2021,232,221,95.260002,208,13
1400000US06037212304,6037212304,2021,3635,3461,95.209999,3351,110
1400000US06037212610,6037212610,2021,759,691,91.040001,647,44
1400000US06037212800,6037212800,2021,2063,1596,77.360001,1503,93
1400000US06037213201,6037213201,2021,579,530,91.540001,513,17
1400000US06037213202,6037213202,2021,514,504,98.050003,491,13
1400000US06037213310,6037213310,2021,104,100,96.150002,96,4
1400000US06037213320,6037213320,2021,998,962,96.389999,932,30
1400000US06037213402,6037213402,2021,640,624,97.5,610,14
1400000US06037214100,6037214100,2021,603,175,29.02,171,4
1400000US06037214501,6037214501,2021,582,189,32.470001,165,24
1400000US06037216201,6037216201,2021,90,84,93.330002,80,4
1400000US06037216301,6037216301,2021,329,211,64.129997,193,18
1400000US06037216700,6037216700,2021,1896,1106,58.330002,938,168
1400000US06037217101,6037217101,2021,277,255,92.059998,242,13
1400000US06037218110,6037218110,2021,1790,1287,71.900002,1240,47
1400000US06037218210,6037218210,2021,381,375,98.43,358,17
1400000US06037218300,6037218300,2021,321,292,90.970001,273,19
1400000US06037218800,6037218800,2021,485,466,96.080002,453,13
1400000US06037218900,6037218900,2021,741,668,90.150002,620,48
1400000US06037219010,6037219010,2021,420,397,94.519997,379,18
1400000US06037219300,6037219300,2021,565,510,90.269997,472,38
1400000US06037219700,6037219700,2021,786,683,86.900002,661,22
1400000US06037219800,6037219800,2021,617,574,93.029999,533,41
1400000US06037219902,6037219902,2021,629,597,94.910004,576,21
1400000US06037220000,6037220000,2021,242,230,95.040001,225,5
1400000US06037220100,6037220100,2021,967,676,69.910004,644,32
1400000US06037221120,6037221120,2021,678,678,100,662,16
1400000US06037221304,6037221304,2021,566,536,94.699997,518,18
1400000US06037221401,6037221401,2021,986,960,97.360001,926,34
1400000US06037221602,6037221602,2021,1932,1868,96.690002,1831,37
1400000US06037221810,6037221810,2021,434,413,95.160004,404,9
1400000US06037221900,6037221900,2021,334,324,97.010002,316,8
1400000US06037222002,6037222002,2021,422,381,90.279999,370,11
1400000US06037222500,6037222500,2021,1849,1703,92.099998,1632,71
1400000US06037222600,6037222600,2021,745,702,94.230003,674,28
1400000US06037224010,6037224010,2021,22,21,95.449997,21,0
1400000US06037224020,6037224020,2021,1755,1659,94.529999,1584,75
1400000US06037224320,6037224320,2021,453,406,89.620003,377,29
1400000US06037224410,6037224410,2021,1819,1722,94.669998,1665,57
1400000US06037224420,6037224420,2021,859,526,61.23,526,0
1400000US06037224600,6037224600,2021,1169,1111,95.040001,1082,29
1400000US06037224702,6037224702,2021,1001,885,88.410004,808,77
1400000US06037226001,6037226001,2021,2775,2717,97.910004,2646,71
1400000US06037226002,6037226002,2021,953,855,89.720001,844,11
1400000US06037226702,6037226702,2021,1178,1152,97.790001,1111,41
1400000US06037227020,6037227020,2021,1167,1153,98.800003,1128,25
1400000US06037228100,6037228100,2021,1636,1601,97.860001,1532,69
1400000US06037228210,6037228210,2021,1583,1503,94.949997,1478,25
1400000US06037228310,6037228310,2021,1247,1224,98.160004,1194,30
1400000US06037228320,6037228320,2021,559,550,98.389999,541,9
1400000US06037228410,6037228410,2021,691,656,94.93,620,36
1400000US06037228420,6037228420,2021,1210,1175,97.110001,1167,8
1400000US06037228500,6037228500,2021,583,574,98.459999,555,19
1400000US06037228600,6037228600,2021,1171,1147,97.949997,1130,17
1400000US06037228710,6037228710,2021,975,950,97.440002,931,19
1400000US06037228720,6037228720,2021,744,737,99.059998,717,20
1400000US06037228800,6037228800,2021,168,167,99.400002,165,2
1400000US06037229200,6037229200,2021,616,605,98.209999,600,5
1400000US06037229300,6037229300,2021,475,459,96.629997,427,32
1400000US06037229410,6037229410,2021,2769,2728,98.519997,2668,60
1400000US06037229420,6037229420,2021,1515,1480,97.690002,1444,36
1400000US06037231100,6037231100,2021,1777,1725,97.07,1671,54
1400000US06037231220,6037231220,2021,1179,1005,85.239998,905,100
1400000US06037231302,6037231302,2021,374,366,97.860001,355,11
1400000US06037231400,6037231400,2021,119,107,89.919998,103,4
1400000US06037231500,6037231500,2021,410,379,92.440002,270,109
1400000US06037231603,6037231603,2021,1037,999,96.339996,980,19
1400000US06037231710,6037231710,2021,406,398,98.029999,395,3
1400000US06037231720,6037231720,2021,272,249,91.540001,234,15
1400000US06037231800,6037231800,2021,597,592,99.160004,587,5
1400000US06037232110,6037232110,2021,1150,1134,98.610001,1120,14
1400000US06037232200,6037232200,2021,1360,1300,95.589996,1145,155
1400000US06037232300,6037232300,2021,248,233,93.949997,223,10
1400000US06037232401,6037232401,2021,772,746,96.629997,716,30
1400000US06037232402,6037232402,2021,217,197,90.779999,185,12
1400000US06037232500,6037232500,2021,530,493,93.019997,480,13
1400000US06037234001,6037234001,2021,676,633,93.639999,577,56
1400000US06037234002,6037234002,2021,399,394,98.75,354,40
1400000US06037234301,6037234301,2021,599,576,96.160004,563,13
1400000US06037234501,6037234501,2021,899,847,94.220001,831,16
1400000US06037234502,6037234502,2021,659,631,95.75,591,40
1400000US06037234600,6037234600,2021,2157,2013,93.32,1850,163
1400000US06037234700,6037234700,2021,229,220,96.07,209,11
1400000US06037234901,6037234901,2021,434,409,94.239998,402,7
1400000US06037234902,6037234902,2021,155,139,89.68,129,10
1400000US06037235201,6037235201,2021,1036,993,95.849998,941,52
1400000US06037236203,6037236203,2021,627,598,95.370003,548,50
1400000US06037236204,6037236204,2021,488,482,98.769997,476,6
1400000US06037236400,6037236400,2021,156,151,96.790001,147,4
1400000US06037237101,6037237101,2021,2449,2362,96.449997,2313,49
1400000US06037237102,6037237102,2021,596,576,96.639999,569,7
1400000US06037237300,6037237300,2021,580,547,94.309998,528,19
1400000US06037237500,6037237500,2021,532,514,96.620003,504,10
1400000US06037237600,6037237600,2021,619,606,97.900002,596,10
1400000US06037237800,6037237800,2021,457,444,97.160004,430,14
1400000US06037237900,6037237900,2021,388,347,89.43,330,17
1400000US06037238000,6037238000,2021,722,710,98.339996,707,3
1400000US06037238100,6037238100,2021,186,181,97.309998,181,0
1400000US06037238200,6037238200,2021,615,590,95.93,561,29
1400000US06037238320,6037238320,2021,1196,1099,91.889999,840,259
1400000US06037238400,6037238400,2021,338,328,97.040001,321,7
1400000US06037239201,6037239201,2021,1085,1081,99.629997,1062,19
1400000US06037239320,6037239320,2021,997,981,98.400002,971,10
1400000US06037239330,6037239330,2021,748,730,97.589996,716,14
1400000US06037239502,6037239502,2021,3320,3260,98.190002,3200,60
1400000US06037239601,6037239601,2021,949,922,97.150002,908,14
1400000US06037239802,6037239802,2021,929,903,97.199997,886,17
1400000US06037240010,6037240010,2021,1053,1031,97.910004,993,38
1400000US06037240020,6037240020,2021,413,375,90.800003,300,75
1400000US06037240200,6037240200,2021,671,654,97.470001,639,15
1400000US06037240301,6037240301,2021,716,692,96.650002,682,10
1400000US06037240302,6037240302,2021,133,130,97.739998,127,3
1400000US06037240401,6037240401,2021,1048,1025,97.809998,991,34
1400000US06037240500,6037240500,2021,1443,1418,98.269997,1348,70
1400000US06037240600,6037240600,2021,916,904,98.690002,892,12
1400000US06037240700,6037240700,2021,501,486,97.010002,474,12
1400000US06037240902,6037240902,2021,2045,2006,98.089996,1925,81
1400000US06037241001,6037241001,2021,827,816,98.669998,777,39
1400000US06037241110,6037241110,2021,971,957,98.559998,939,18
1400000US06037241120,6037241120,2021,464,464,100,456,8
1400000US06037241202,6037241202,2021,569,557,97.889999,542,15
1400000US06037241400,6037241400,2021,501,493,98.400002,481,12
1400000US06037242000,6037242000,2021,310,309,99.68,301,8
1400000US06037242100,6037242100,2021,810,795,98.150002,776,19
1400000US06037242201,6037242201,2021,742,727,97.980003,714,13
1400000US06037242202,6037242202,2021,683,665,97.360001,619,46
1400000US06037242300,6037242300,2021,638,629,98.589996,613,16
1400000US06037242600,6037242600,2021,577,571,98.959999,564,7
1400000US06037242700,6037242700,2021,1158,1138,98.269997,1129,9
1400000US06037243001,6037243001,2021,503,489,97.220001,474,15
1400000US06037243002,6037243002,2021,377,372,98.669998,366,6
1400000US06037243100,6037243100,2021,426,419,98.360001,416,3
1400000US06037262200,6037262200,2021,871,170,19.52,159,11
1400000US06037262303,6037262303,2021,482,47,9.75,43,4
1400000US06037262604,6037262604,2021,426,57,13.38,55,2
1400000US06037262704,6037262704,2021,2995,757,25.280001,714,43
1400000US06037262706,6037262706,2021,455,45,9.8900003,44,1
1400000US06037262802,6037262802,2021,2370,555,23.42,527,28
1400000US06037264305,6037264305,2021,353,307,86.970001,289,18
1400000US06037265100,6037265100,2021,630,38,6.0300002,38,0
1400000US06037265601,6037265601,2021,946,343,36.259998,307,36
1400000US06037267202,6037267202,2021,757,102,13.47,90,12
1400000US06037267300,6037267300,2021,218,170,77.980003,155,15
1400000US06037267404,6037267404,2021,1445,1039,71.900002,923,116
1400000US06037267406,6037267406,2021,181,144,79.559998,133,11
1400000US06037267600,6037267600,2021,1023,250,24.440001,212,38
1400000US06037269000,6037269000,2021,550,171,31.09,158,13
1400000US06037269100,6037269100,2021,387,120,31.01,118,2
1400000US06037269300,6037269300,2021,461,48,10.41,47,1
1400000US06037269700,6037269700,2021,2868,2028,70.709999,1852,176
1400000US06037269907,6037269907,2021,292,218,74.660004,210,8
1400000US06037271200,6037271200,2021,601,253,42.099998,210,43
1400000US06037271300,6037271300,2021,828,536,64.730003,517,19
1400000US06037271400,6037271400,2021,248,92,37.099998,85,7
1400000US06037271500,6037271500,2021,562,66,11.74,62,4
1400000US06037271702,6037271702,2021,472,132,27.969999,129,3
1400000US06037271703,6037271703,2021,1291,775,60.029999,725,50
1400000US06037271801,6037271801,2021,267,193,72.279999,186,7
1400000US06037272100,6037272100,2021,1217,695,57.110001,654,41
1400000US06037272302,6037272302,2021,18,12,66.669998,11,1
1400000US06037273200,6037273200,2021,1077,553,51.349998,493,60
1400000US06037273403,6037273403,2021,398,312,78.389999,286,26
1400000US06037273800,6037273800,2021,2536,1506,59.380001,1376,130
1400000US06037274202,6037274202,2021,339,283,83.480003,267,16
1400000US06037275200,6037275200,2021,517,481,93.040001,444,37
1400000US06037275311,6037275311,2021,1460,654,44.790001,609,45
1400000US06037275400,6037275400,2021,303,151,49.830002,135,16
1400000US06037275500,6037275500,2021,817,562,68.790001,512,50
1400000US06037275603,6037275603,2021,268,115,42.91,100,15
1400000US06037275604,6037275604,2021,512,74,14.45,70,4
1400000US06037275605,6037275605,2021,355,308,86.760002,266,42
1400000US06037276000,6037276000,2021,209,122,58.369999,109,13
1400000US06037276400,6037276400,2021,314,95,30.25,90,5
1400000US06037276605,6037276605,2021,251,165,65.739998,153,12
1400000US06037276607,6037276607,2021,268,185,69.029999,172,13
1400000US06037276608,6037276608,2021,1112,662,59.529999,608,54
1400000US06037277000,6037277000,2021,1671,791,47.34,731,60
1400000US06037277100,6037277100,2021,395,72,18.23,67,5
1400000US06037291120,6037291120,2021,600,565,94.169998,534,31
1400000US06037291210,6037291210,2021,486,448,92.18,435,13
1400000US06037291220,6037291220,2021,346,311,89.879997,293,18
1400000US06037291300,6037291300,2021,885,685,77.400002,634,51
1400000US06037293204,6037293204,2021,453,397,87.639999,373,24
1400000US06037293302,6037293302,2021,2720,2175,79.959999,1974,201
1400000US06037293304,6037293304,2021,454,427,94.050003,415,12
1400000US06037294110,6037294110,2021,3199,2868,89.650002,2689,179
1400000US06037294200,6037294200,2021,1578,1464,92.779999,1391,73
1400000US06037294302,6037294302,2021,454,292,64.32,210,82
1400000US06037294410,6037294410,2021,274,264,96.349998,256,8
1400000US06037294510,6037294510,2021,697,650,93.260002,608,42
1400000US06037294520,6037294520,2021,372,358,96.239998,339,19
1400000US06037294610,6037294610,2021,1197,1083,90.480003,1023,60
1400000US06037294620,6037294620,2021,575,557,96.870003,533,24
1400000US06037294830,6037294830,2021,614,595,96.910004,566,29
1400000US06037294900,6037294900,2021,533,522,97.940002,508,14
1400000US06037295103,6037295103,2021,829,444,53.560001,394,50
1400000US06037296220,6037296220,2021,969,555,57.279999,498,57
1400000US06037296300,6037296300,2021,621,341,54.91,286,55
1400000US06037296401,6037296401,2021,331,212,64.050003,193,19
1400000US06037296500,6037296500,2021,697,643,92.25,621,22
1400000US06037296600,6037296600,2021,338,326,96.449997,313,13
1400000US06037296901,6037296901,2021,4205,2783,66.18,2545,238
1400000US06037297110,6037297110,2021,156,127,81.410004,119,8
1400000US06037297120,6037297120,2021,426,390,91.550003,371,19
1400000US06037297202,6037297202,2021,415,352,84.82,314,38
1400000US06037297400,6037297400,2021,447,225,50.34,190,35
1400000US06037297501,6037297501,2021,322,126,39.130001,109,17
1400000US06037297601,6037297601,2021,65,54,83.080002,53,1
1400000US06037297602,6037297602,2021,333,216,64.860001,181,35
1400000US06037300200,6037300200,2021,2473,412,16.66,348,64
1400000US06037300301,6037300301,2021,2354,846,35.939999,666,180
1400000US06037300400,6037300400,2021,489,105,21.469999,92,13
1400000US06037300501,6037300501,2021,2963,701,23.66,609,92
1400000US06037300602,6037300602,2021,641,126,19.66,103,23
1400000US06037300800,6037300800,2021,691,176,25.469999,151,25
1400000US06037300902,6037300902,2021,494,152,30.77,136,16
1400000US06037301000,6037301000,2021,1167,672,57.580002,575,97
1400000US06037301206,6037301206,2021,3613,1891,52.34,1604,287
1400000US06037301400,6037301400,2021,837,471,56.27,414,57
1400000US06037301502,6037301502,2021,655,448,68.400002,403,45
1400000US06037301602,6037301602,2021,607,82,13.51,75,7
1400000US06037301801,6037301801,2021,444,320,72.07,279,41
1400000US06037301902,6037301902,2021,928,541,58.299999,484,57
1400000US06037302002,6037302002,2021,108,61,56.48,58,3
1400000US06037302004,6037302004,2021,440,367,83.410004,326,41
1400000US06037302104,6037302104,2021,2022,1335,66.019997,1144,191
1400000US06037302302,6037302302,2021,881,448,50.849998,381,67
1400000US06037302504,6037302504,2021,2214,1707,77.099998,1487,220
1400000US06037302505,6037302505,2021,432,316,73.150002,273,43
1400000US06037310201,6037310201,2021,589,182,30.9,166,16
1400000US06037310300,6037310300,2021,2151,676,31.43,614,62
1400000US06037310601,6037310601,2021,432,224,51.849998,200,24
1400000US06037310602,6037310602,2021,2450,910,37.139999,835,75
1400000US06037310703,6037310703,2021,727,309,42.5,293,16
1400000US06037310705,6037310705,2021,15,11,73.330002,9,2
1400000US06037310800,6037310800,2021,2855,882,30.889999,784,98
1400000US06037310900,6037310900,2021,607,141,23.23,123,18
1400000US06037311000,6037311000,2021,947,355,37.490002,293,62
1400000US06037311100,6037311100,2021,899,334,37.150002,287,47
1400000US06037311200,6037311200,2021,110,14,12.73,14,0
1400000US06037311500,6037311500,2021,1182,192,16.24,164,28
1400000US06037311700,6037311700,2021,1057,334,31.6,289,45
1400000US06037311802,6037311802,2021,456,153,33.549999,136,17
1400000US06037320101,6037320101,2021,475,423,89.050003,388,35
1400000US06037320102,6037320102,2021,1638,1487,90.779999,1400,87
1400000US06037320201,6037320201,2021,1314,1239,94.290001,1165,74
1400000US06037320202,6037320202,2021,453,417,92.050003,396,21
1400000US06037320300,6037320300,2021,1816,1721,94.769997,1600,121
1400000US06037400205,6037400205,2021,40,40,100,40,0
1400000US06037400208,6037400208,2021,548,89,16.24,79,10
1400000US06037400304,6037400304,2021,886,418,47.18,367,51
1400000US06037400402,6037400402,2021,2265,572,25.25,509,63
1400000US06037400403,6037400403,2021,32,32,100,32,0
1400000US06037400404,6037400404,2021,564,97,17.200001,87,10
1400000US06037400501,6037400501,2021,814,159,19.530001,151,8
1400000US06037400602,6037400602,2021,615,424,68.940002,364,60
1400000US06037400605,6037400605,2021,326,263,80.669998,241,22
1400000US06037400801,6037400801,2021,1948,713,36.599998,649,64
1400000US06037401001,6037401001,2021,556,113,20.32,113,0
1400000US06037401202,6037401202,2021,848,337,39.740002,297,40
1400000US06037401203,6037401203,2021,282,116,41.130001,114,2
1400000US06037401311,6037401311,2021,1107,295,26.65,255,40
1400000US06037401312,6037401312,2021,2193,864,39.400002,746,118
1400000US06037401601,6037401601,2021,459,132,28.76,122,10
1400000US06037401602,6037401602,2021,2504,915,36.540001,787,128
1400000US06037401705,6037401705,2021,461,193,41.869999,189,4
1400000US06037401707,6037401707,2021,350,338,96.57,302,36
1400000US06037401801,6037401801,2021,639,114,17.84,108,6
1400000US06037401802,6037401802,2021,2994,719,24.01,673,46
1400000US06037401902,6037401902,2021,1871,528,28.219999,491,37
1400000US06037402001,6037402001,2021,325,163,50.150002,149,14
1400000US06037402002,6037402002,2021,309,125,40.450001,109,16
1400000US06037402101,6037402101,2021,294,288,97.959999,259,29
1400000US06037402102,6037402102,2021,2025,1923,94.959999,1646,277
1400000US06037402200,6037402200,2021,332,300,90.360001,241,59
1400000US06037402301,6037402301,2021,1167,1095,93.830002,965,130
1400000US06037402303,6037402303,2021,322,307,95.339996,284,23
1400000US06037402403,6037402403,2021,781,468,59.919998,398,70
1400000US06037402405,6037402405,2021,900,869,96.559998,769,100
1400000US06037402406,6037402406,2021,962,938,97.510002,851,87
1400000US06037402501,6037402501,2021,1140,1122,98.419998,1046,76
1400000US06037402503,6037402503,2021,827,801,96.860001,720,81
1400000US06037402504,6037402504,2021,452,445,98.449997,397,48
1400000US06037402601,6037402601,2021,660,646,97.879997,595,51
1400000US06037402702,6037402702,2021,1146,1069,93.279999,977,92
1400000US06037402703,6037402703,2021,283,266,93.989998,229,37
1400000US06037402705,6037402705,2021,520,497,95.580002,466,31
1400000US06037402706,6037402706,2021,249,245,98.389999,224,21
1400000US06037402902,6037402902,2021,571,552,96.669998,497,55
1400000US06037402903,6037402903,2021,1481,1427,96.349998,1304,123
1400000US06037403000,6037403000,2021,2914,2836,97.32,2537,299
1400000US06037403316,6037403316,2021,925,687,74.269997,496,191
1400000US06037403317,6037403317,2021,1958,1465,74.82,1055,410
1400000US06037403318,6037403318,2021,451,354,78.489998,259,95
1400000US06037403320,6037403320,2021,430,235,54.650002,169,66
1400000US06037403321,6037403321,2021,275,216,78.550003,155,61
1400000US06037403323,6037403323,2021,1680,388,23.1,371,17
1400000US06037403324,6037403324,2021,665,147,22.110001,140,7
1400000US06037403325,6037403325,2021,3822,796,20.83,761,35
1400000US06037403326,6037403326,2021,644,162,25.16,155,7
1400000US06037403327,6037403327,2021,303,216,71.290001,163,53
1400000US06037403401,6037403401,2021,456,129,28.290001,122,7
1400000US06037403402,6037403402,2021,2783,673,24.18,639,34
1400000US06037403404,6037403404,2021,1162,271,23.32,249,22
1400000US06037403407,6037403407,2021,614,123,20.030001,120,3
1400000US06037403408,6037403408,2021,944,433,45.869999,367,66
1400000US06037403409,6037403409,2021,570,155,27.190001,151,4
1400000US06037403601,6037403601,2021,816,523,64.089996,454,69
1400000US06037403702,6037403702,2021,1793,884,49.299999,793,91
1400000US06037403703,6037403703,2021,365,216,59.18,201,15
1400000US06037403722,6037403722,2021,670,391,58.360001,357,34
1400000US06037403801,6037403801,2021,1033,689,66.699997,634,55
1400000US06037403901,6037403901,2021,56,24,42.860001,24,0
1400000US06037403902,6037403902,2021,400,187,46.75,177,10
1400000US06037404000,6037404000,2021,548,471,85.949997,424,47
1400000US06037404100,6037404100,2021,289,262,90.660004,242,20
1400000US06037404201,6037404201,2021,1674,1411,84.290001,1256,155
1400000US06037404203,6037404203,2021,287,209,72.82,194,15
1400000US06037404401,6037404401,2021,418,339,81.099998,296,43
1400000US06037404402,6037404402,2021,631,519,82.25,472,47
1400000US06037404503,6037404503,2021,456,408,89.470001,356,52
1400000US06037404504,6037404504,2021,489,467,95.5,443,24
1400000US06037404600,6037404600,2021,2529,2011,79.519997,1734,277
1400000US06037404701,6037404701,2021,723,641,88.660004,640,1
1400000US06037404702,6037404702,2021,644,601,93.32,600,1
1400000US06037404804,6037404804,2021,2525,2090,82.769997,2083,7
1400000US06037404805,6037404805,2021,497,451,90.739998,450,1
1400000US06037404806,6037404806,2021,890,794,89.209999,793,1
1400000US06037404901,6037404901,2021,461,392,85.029999,391,1
1400000US06037404903,6037404903,2021,435,371,85.290001,371,0
1400000US06037405001,6037405001,2021,845,722,85.440002,720,2
1400000US06037405002,6037405002,2021,323,295,91.330002,292,3
1400000US06037405101,6037405101,2021,1298,1113,85.75,1109,4
1400000US06037405201,6037405201,2021,2068,1775,85.830002,1771,4
1400000US06037405202,6037405202,2021,606,524,86.470001,524,0
1400000US06037405302,6037405302,2021,484,351,72.519997,310,41
1400000US06037405400,6037405400,2021,422,299,70.849998,266,33
1400000US06037405600,6037405600,2021,983,697,70.910004,578,119
1400000US06037405701,6037405701,2021,781,601,76.949997,527,74
1400000US06037405702,6037405702,2021,1291,923,71.489998,789,134
1400000US06037405800,6037405800,2021,1466,1163,79.330002,1026,137
1400000US06037406000,6037406000,2021,1797,1259,70.059998,1067,192
1400000US06037406103,6037406103,2021,585,398,68.029999,359,39
1400000US06037406201,6037406201,2021,1151,838,72.809998,713,125
1400000US06037406300,6037406300,2021,2382,1234,51.810001,1010,224
1400000US06037406413,6037406413,2021,1426,905,63.459999,753,152
1400000US06037406601,6037406601,2021,3333,2382,71.470001,2067,315
1400000US06037406602,6037406602,2021,331,252,76.129997,225,27
1400000US06037406701,6037406701,2021,241,203,84.230003,178,25
1400000US06037406702,6037406702,2021,194,156,80.410004,135,21
1400000US06037406801,6037406801,2021,1959,1418,72.379997,1175,243
1400000US06037406903,6037406903,2021,2212,1531,69.209999,1336,195
1400000US06037407001,6037407001,2021,341,314,92.080002,286,28
1400000US06037407002,6037407002,2021,411,385,93.669998,357,28
1400000US06037407101,6037407101,2021,1552,1398,90.080002,1260,138
1400000US06037407201,6037407201,2021,263,243,92.400002,207,36
1400000US06037407301,6037407301,2021,324,287,88.580002,265,22
1400000US06037407302,6037407302,2021,1090,951,87.25,833,118
1400000US06037407501,6037407501,2021,857,692,80.75,562,130
1400000US06037407502,6037407502,2021,617,502,81.360001,430,72
1400000US06037407602,6037407602,2021,525,455,86.669998,412,43
1400000US06037407701,6037407701,2021,477,457,95.809998,429,28
1400000US06037407702,6037407702,2021,1375,1214,88.290001,1036,178
1400000US06037407801,6037407801,2021,448,381,85.040001,330,51
1400000US06037407802,6037407802,2021,1871,1621,86.639999,1408,213
1400000US06037407901,6037407901,2021,550,445,80.910004,382,63
1400000US06037408003,6037408003,2021,78,66,84.620003,63,3
1400000US06037408135,6037408135,2021,567,502,88.540001,466,36
1400000US06037408136,6037408136,2021,357,280,78.43,255,25
1400000US06037408137,6037408137,2021,684,530,77.489998,492,38
1400000US06037408138,6037408138,2021,374,337,90.110001,324,13
1400000US06037408139,6037408139,2021,406,359,88.419998,333,26
1400000US06037408140,6037408140,2021,579,516,89.120003,475,41
1400000US06037408141,6037408141,2021,2151,1796,83.5,1637,159
1400000US06037408212,6037408212,2021,665,389,58.5,360,29
1400000US06037408213,6037408213,2021,389,323,83.029999,291,32
1400000US06037408301,6037408301,2021,522,481,92.150002,451,30
1400000US06037408302,6037408302,2021,619,376,60.740002,303,73
1400000US06037408401,6037408401,2021,10,2,20,2,0
1400000US06037408402,6037408402,2021,838,683,81.5,567,116
1400000US06037408503,6037408503,2021,922,392,42.52,319,73
1400000US06037408504,6037408504,2021,584,288,49.32,252,36
1400000US06037408505,6037408505,2021,2016,1486,73.709999,1187,299
1400000US06037408623,6037408623,2021,2057,1040,50.560001,843,197
1400000US06037408624,6037408624,2021,240,198,82.5,161,37
1400000US06037408625,6037408625,2021,1685,747,44.330002,595,152
1400000US06037408631,6037408631,2021,556,422,75.900002,357,65
1400000US06037408705,6037408705,2021,2950,1817,61.59,1627,190
1400000US06037408707,6037408707,2021,900,216,24,201,15
1400000US06037408722,6037408722,2021,651,372,57.139999,322,50
1400000US06037408724,6037408724,2021,485,426,87.839996,404,22
1400000US06037408725,6037408725,2021,708,488,68.93,435,53
1400000US06037408900,6037408900,2021,1761,636,36.119999,550,86
1400000US06037409000,6037409000,2021,525,490,93.330002,427,63
1400000US06037409100,6037409100,2021,169,144,85.209999,130,14
1400000US06037430003,6037430003,2021,358,195,54.470001,164,31
1400000US06037430005,6037430005,2021,365,298,81.639999,257,41
1400000US06037430101,6037430101,2021,1948,880,45.169998,750,130
1400000US06037430102,6037430102,2021,421,361,85.75,318,43
1400000US06037430200,6037430200,2021,812,386,47.540001,308,78
1400000US06037430302,6037430302,2021,495,184,37.169998,169,15
1400000US06037430400,6037430400,2021,1310,246,18.780001,202,44
1400000US06037430502,6037430502,2021,1215,400,32.919998,271,129
1400000US06037430701,6037430701,2021,565,175,30.969999,143,32
1400000US06037430721,6037430721,2021,2954,745,25.219999,653,92
1400000US06037430801,6037430801,2021,825,255,30.91,213,42
1400000US06037430802,6037430802,2021,1321,413,31.26,352,61
1400000US06037431002,6037431002,2021,507,337,66.470001,307,30
1400000US06037431003,6037431003,2021,1545,864,55.919998,756,108
1400000US06037431004,6037431004,2021,1612,941,58.369999,821,120
1400000US06037431100,6037431100,2021,481,344,71.519997,296,48
1400000US06037431200,6037431200,2021,449,372,82.849998,343,29
1400000US06037431400,6037431400,2021,482,263,54.560001,235,28
1400000US06037431501,6037431501,2021,393,302,76.839996,185,117
1400000US06037431502,6037431502,2021,654,570,87.160004,374,196
1400000US06037431600,6037431600,2021,483,138,28.57,113,25
1400000US06037431701,6037431701,2021,1324,410,30.969999,338,72
1400000US06037431800,6037431800,2021,1906,858,45.02,698,160
1400000US06037431900,6037431900,2021,916,431,47.049999,347,84
1400000US06037432002,6037432002,2021,432,190,43.98,155,35
1400000US06037432102,6037432102,2021,571,224,39.23,179,45
1400000US06037432201,6037432201,2021,460,324,70.43,255,69
1400000US06037432202,6037432202,2021,2543,2019,79.389999,1729,290
1400000US06037432300,6037432300,2021,822,759,92.339996,510,249
1400000US06037432401,6037432401,2021,2647,2306,87.120003,1914,392
1400000US06037432402,6037432402,2021,476,427,89.709999,304,123
1400000US06037432501,6037432501,2021,315,282,89.519997,208,74
1400000US06037432602,6037432602,2021,1316,1175,89.290001,948,227
1400000US06037432700,6037432700,2021,9,6,66.669998,6,0
1400000US06037432801,6037432801,2021,524,498,95.040001,371,127
1400000US06037432902,6037432902,2021,395,318,80.510002,269,49
1400000US06037433103,6037433103,2021,387,370,95.610001,283,87
1400000US06037433200,6037433200,2021,2618,2407,91.940002,2069,338
1400000US06037433302,6037433302,2021,524,511,97.519997,501,10
1400000US06037433305,6037433305,2021,507,487,96.059998,481,6
1400000US06037433306,6037433306,2021,403,395,98.010002,391,4
1400000US06037433307,6037433307,2021,681,650,95.449997,634,16
1400000US06037433505,6037433505,2021,1143,1093,95.629997,820,273
1400000US06037433803,6037433803,2021,1738,1538,88.489998,1395,143
1400000US06037433804,6037433804,2021,1009,961,95.239998,931,30
1400000US06037433901,6037433901,2021,424,417,98.349998,416,1
1400000US06037433903,6037433903,2021,1053,1031,97.910004,1013,18
1400000US06037434001,6037434001,2021,1337,1228,91.849998,1138,90
1400000US06037434003,6037434003,2021,1089,1052,96.599998,1024,28
1400000US06037434100,6037434100,2021,501,378,75.449997,326,52
1400000US06037460002,6037460002,2021,471,250,53.080002,192,58
1400000US06037460101,6037460101,2021,392,67,17.09,64,3
1400000US06037460200,6037460200,2021,182,130,71.43,118,12
1400000US06037460301,6037460301,2021,426,157,36.849998,151,6
1400000US06037460302,6037460302,2021,471,131,27.809999,120,11
1400000US06037460501,6037460501,2021,680,24,3.53,24,0
1400000US06037460502,6037460502,2021,599,28,4.6700001,28,0
1400000US06037460601,6037460601,2021,620,26,4.1900001,26,0
1400000US06037460700,6037460700,2021,2014,101,5.0100002,101,0
1400000US06037460900,6037460900,2021,1160,837,72.160004,739,98
1400000US06037461000,6037461000,2021,662,418,63.139999,359,59
1400000US06037461100,6037461100,2021,469,298,63.540001,274,24
1400000US06037461200,6037461200,2021,517,370,71.57,338,32
1400000US06037461300,6037461300,2021,335,218,65.07,184,34
1400000US06037461400,6037461400,2021,623,524,84.110001,453,71
1400000US06037461502,6037461502,2021,920,799,86.849998,751,48
1400000US06037462100,6037462100,2021,482,438,90.870003,417,21
1400000US06037462500,6037462500,2021,2212,1400,63.290001,1186,214
1400000US06037462600,6037462600,2021,1996,1423,71.290001,1142,281
1400000US06037462900,6037462900,2021,151,138,91.389999,133,5
1400000US06037463000,6037463000,2021,449,127,28.290001,78,49
1400000US06037463200,6037463200,2021,569,367,64.5,315,52
1400000US06037463300,6037463300,2021,535,288,53.830002,225,63
1400000US06037463601,6037463601,2021,1042,801,76.870003,728,73
1400000US06037463800,6037463800,2021,400,157,39.25,120,37
1400000US06037464000,6037464000,2021,1073,606,56.48,527,79
1400000US06037464101,6037464101,2021,1256,97,7.7199998,93,4
1400000US06037464200,6037464200,2021,921,76,8.25,75,1
1400000US06037480002,6037480002,2021,891,136,15.26,124,12
1400000US06037480012,6037480012,2021,1563,660,42.23,517,143
1400000US06037480201,6037480201,2021,316,117,37.029999,105,12
1400000US06037480202,6037480202,2021,438,221,50.459999,190,31
1400000US06037480302,6037480302,2021,382,243,63.610001,224,19
1400000US06037480304,6037480304,2021,2639,1619,61.349998,1417,202
1400000US06037480400,6037480400,2021,1566,831,53.07,721,110
1400000US06037480500,6037480500,2021,1925,301,15.64,271,30
1400000US06037480702,6037480702,2021,622,93,14.95,82,11
1400000US06037480703,6037480703,2021,675,93,13.78,84,9
1400000US06037480704,6037480704,2021,1422,253,17.790001,222,31
1400000US06037480803,6037480803,2021,427,234,54.799999,211,23
1400000US06037480804,6037480804,2021,707,371,52.48,334,37
1400000US06037480901,6037480901,2021,86,53,61.630001,51,2
1400000US06037480903,6037480903,2021,856,488,57.009998,420,68
1400000US06037481101,6037481101,2021,451,333,73.839996,279,54
1400000US06037481102,6037481102,2021,24,16,66.669998,16,0
1400000US06037481103,6037481103,2021,1924,1298,67.459999,1195,103
1400000US06037481203,6037481203,2021,1435,858,59.790001,783,75
1400000US06037481300,6037481300,2021,566,410,72.440002,329,81
1400000US06037481401,6037481401,2021,587,391,66.610001,328,63
1400000US06037481403,6037481403,2021,415,286,68.919998,264,22
1400000US06037481404,6037481404,2021,1629,909,55.799999,772,137
1400000US06037481500,6037481500,2021,2213,1093,49.389999,966,127
1400000US06037481606,6037481606,2021,761,491,64.519997,447,44
1400000US06037481901,6037481901,2021,562,284,50.529999,260,24
1400000US06037482001,6037482001,2021,975,385,39.490002,331,54
1400000US06037482002,6037482002,2021,876,305,34.82,265,40
1400000US06037482101,6037482101,2021,763,536,70.25,486,50
1400000US06037482102,6037482102,2021,736,337,45.790001,289,48
1400000US06037482202,6037482202,2021,545,320,58.720001,297,23
1400000US06037482303,6037482303,2021,138,103,74.639999,99,4
1400000US06037482304,6037482304,2021,435,346,79.540001,330,16
1400000US06037482401,6037482401,2021,322,242,75.160004,226,16
1400000US06037482403,6037482403,2021,1024,795,77.639999,751,44
1400000US06037482502,6037482502,2021,1099,791,71.970001,737,54
1400000US06037482522,6037482522,2021,391,213,54.48,179,34
1400000US06037482600,6037482600,2021,411,231,56.200001,204,27
1400000US06037482701,6037482701,2021,513,333,64.910004,295,38
1400000US06037482801,6037482801,2021,655,415,63.360001,362,53
1400000US06037500202,6037500202,2021,3764,1789,47.529999,1514,275
1400000US06037500203,6037500203,2021,548,113,20.620001,112,1
1400000US06037500300,6037500300,2021,385,249,64.68,224,25
1400000US06037500402,6037500402,2021,591,441,74.620003,394,47
1400000US06037500404,6037500404,2021,361,249,68.980003,227,22
1400000US06037500600,6037500600,2021,665,529,79.550003,458,71
1400000US06037500700,6037500700,2021,448,288,64.290001,259,29
1400000US06037500800,6037500800,2021,2729,1792,65.669998,1601,191
1400000US06037500900,6037500900,2021,480,340,70.830002,311,29
1400000US06037501001,6037501001,2021,335,270,80.599998,231,39
1400000US06037501002,6037501002,2021,1386,1103,79.580002,974,129
1400000US06037501200,6037501200,2021,350,270,77.139999,246,24
1400000US06037501302,6037501302,2021,1283,971,75.68,859,112
1400000US06037501400,6037501400,2021,1850,1380,74.589996,1158,222
1400000US06037501600,6037501600,2021,400,294,73.5,267,27
1400000US06037501700,6037501700,2021,662,240,36.25,224,16
1400000US06037501804,6037501804,2021,401,318,79.300003,298,20
1400000US06037502003,6037502003,2021,390,323,82.82,278,45
1400000US06037502005,6037502005,2021,544,386,70.959999,367,19
1400000US06037502200,6037502200,2021,558,366,65.589996,293,73
1400000US06037502303,6037502303,2021,2254,1760,78.080002,1549,211
1400000US06037502401,6037502401,2021,1214,879,72.410004,782,97
1400000US06037502500,6037502500,2021,225,148,65.779999,130,18
1400000US06037502602,6037502602,2021,385,282,73.25,256,26
1400000US06037502603,6037502603,2021,590,392,66.440002,346,46
1400000US06037502604,6037502604,2021,365,269,73.699997,238,31
1400000US06037502700,6037502700,2021,723,498,68.879997,386,112
1400000US06037502801,6037502801,2021,3348,2285,68.25,1652,633
1400000US06037503103,6037503103,2021,425,360,84.709999,320,40
1400000US06037503105,6037503105,2021,506,405,80.040001,338,67
1400000US06037503201,6037503201,2021,408,252,61.759998,242,10
1400000US06037503202,6037503202,2021,347,277,79.830002,237,40
1400000US06037503302,6037503302,2021,3253,2260,69.470001,1908,352
1400000US06037503402,6037503402,2021,564,173,30.67,166,7
1400000US06037503501,6037503501,2021,1011,545,53.91,535,10
1400000US06037503502,6037503502,2021,608,375,61.68,370,5
1400000US06037503602,6037503602,2021,2385,1216,50.990002,1102,114
1400000US06037503701,6037503701,2021,1664,697,41.889999,679,18
1400000US06037503705,6037503705,2021,260,141,54.23,132,9
1400000US06037503801,6037503801,2021,983,515,52.389999,477,38
1400000US06037503802,6037503802,2021,358,185,51.68,166,19
1400000US06037503902,6037503902,2021,472,207,43.860001,192,15
1400000US06037504002,6037504002,2021,1324,649,49.02,599,50
1400000US06037504101,6037504101,2021,270,213,78.889999,197,16
1400000US06037504200,6037504200,2021,1608,1331,82.769997,1116,215
1400000US06037530005,6037530005,2021,2528,1576,62.34,1448,128
1400000US06037530007,6037530007,2021,1734,1365,78.720001,1241,124
1400000US06037530101,6037530101,2021,301,270,89.699997,252,18
1400000US06037530102,6037530102,2021,3883,3044,78.389999,2813,231
1400000US06037530202,6037530202,2021,653,623,95.410004,574,49
1400000US06037530203,6037530203,2021,487,416,85.419998,388,28
1400000US06037530301,6037530301,2021,3412,3239,94.93,3092,147
1400000US06037530400,6037530400,2021,1823,1591,87.269997,1410,181
1400000US06037530500,6037530500,2021,570,526,92.279999,497,29
1400000US06037530603,6037530603,2021,617,525,85.089996,481,44
1400000US06037530700,6037530700,2021,588,531,90.309998,483,48
1400000US06037530801,6037530801,2021,301,289,96.010002,283,6
1400000US06037530902,6037530902,2021,523,506,96.75,488,18
1400000US06037531000,6037531000,2021,3155,2989,94.739998,2836,153
1400000US06037531101,6037531101,2021,2838,2521,88.830002,2408,113
1400000US06037531102,6037531102,2021,801,766,95.629997,746,20
1400000US06037531201,6037531201,2021,696,670,96.260002,650,20
1400000US06037531202,6037531202,2021,134,126,94.029999,120,6
1400000US06037531302,6037531302,2021,1149,1063,92.519997,913,150
1400000US06037531502,6037531502,2021,870,804,92.410004,768,36
1400000US06037531503,6037531503,2021,467,455,97.43,437,18
1400000US06037531603,6037531603,2021,1318,1239,94.010002,1183,56
1400000US06037531604,6037531604,2021,216,211,97.690002,196,15
1400000US06037531701,6037531701,2021,569,419,73.639999,332,87
1400000US06037531702,6037531702,2021,507,439,86.589996,414,25
1400000US06037531800,6037531800,2021,618,518,83.82,484,34
1400000US06037531902,6037531902,2021,467,414,88.650002,374,40
1400000US06037532002,6037532002,2021,502,337,67.129997,318,19
1400000US06037532101,6037532101,2021,23,19,82.610001,18,1
1400000US06037532102,6037532102,2021,773,690,89.260002,653,37
1400000US06037532200,6037532200,2021,149,109,73.150002,105,4
1400000US06037532302,6037532302,2021,370,313,84.589996,300,13
1400000US06037532303,6037532303,2021,736,557,75.68,498,59
1400000US06037532500,6037532500,2021,3043,2928,96.220001,2749,179
1400000US06037532605,6037532605,2021,268,229,85.449997,213,16
1400000US06037532607,6037532607,2021,2091,1988,95.07,1887,101
1400000US06037532700,6037532700,2021,878,859,97.839996,817,42
1400000US06037532800,6037532800,2021,2642,2584,97.800003,2533,51
1400000US06037532900,6037532900,2021,1666,1641,98.5,1607,34
1400000US06037533103,6037533103,2021,2715,2579,94.989998,2424,155
1400000US06037533108,6037533108,2021,2239,2169,96.870003,2085,84
1400000US06037533201,6037533201,2021,501,470,93.809998,439,31
1400000US06037533204,6037533204,2021,498,445,89.360001,424,21
1400000US06037533402,6037533402,2021,1342,1251,93.220001,1144,107
1400000US06037533403,6037533403,2021,1495,1419,94.919998,1353,66
1400000US06037533501,6037533501,2021,1371,1326,96.720001,1257,69
1400000US06037533504,6037533504,2021,778,727,93.440002,651,76
1400000US06037533601,6037533601,2021,756,710,93.919998,679,31
1400000US06037533602,6037533602,2021,2458,2212,89.989998,2055,157
1400000US06037533603,6037533603,2021,2351,2204,93.75,2034,170
1400000US06037533701,6037533701,2021,1345,1254,93.230003,1169,85
1400000US06037533703,6037533703,2021,538,500,92.940002,481,19
1400000US06037533804,6037533804,2021,610,556,91.150002,506,50
1400000US06037533901,6037533901,2021,3258,2540,77.959999,2374,166
1400000US06037533902,6037533902,2021,539,459,85.160004,437,22
1400000US06037534001,6037534001,2021,712,664,93.260002,598,66
1400000US06037534002,6037534002,2021,717,622,86.75,559,63
1400000US06037534102,6037534102,2021,979,924,94.379997,846,78
1400000US06037534201,6037534201,2021,856,731,85.400002,687,44
1400000US06037534302,6037534302,2021,357,336,94.120003,311,25
1400000US06037534404,6037534404,2021,1186,1123,94.690002,1071,52
1400000US06037534405,6037534405,2021,1507,1474,97.809998,1436,38
1400000US06037534406,6037534406,2021,1240,1182,95.32,1134,48
1400000US06037534501,6037534501,2021,927,869,93.739998,813,56
1400000US06037534803,6037534803,2021,564,529,93.790001,509,20
1400000US06037534804,6037534804,2021,440,366,83.18,342,24
1400000US06037534900,6037534900,2021,2541,2398,94.370003,2087,311
1400000US06037535001,6037535001,2021,1494,1448,96.919998,1421,27
1400000US06037535101,6037535101,2021,2864,2761,96.400002,2638,123
1400000US06037535102,6037535102,2021,602,590,98.010002,565,25
1400000US06037535300,6037535300,2021,1205,1160,96.269997,1098,62
1400000US06037535501,6037535501,2021,527,506,96.019997,481,25
1400000US06037535603,6037535603,2021,462,440,95.239998,416,24
1400000US06037535604,6037535604,2021,472,456,96.610001,431,25
1400000US06037535605,6037535605,2021,1591,1393,87.550003,1145,248
1400000US06037535607,6037535607,2021,4003,3774,94.279999,3565,209
1400000US06037535701,6037535701,2021,546,525,96.150002,491,34
1400000US06037535702,6037535702,2021,2717,2496,91.870003,2318,178
1400000US06037535803,6037535803,2021,379,368,97.099998,350,18
1400000US06037535901,6037535901,2021,1498,1349,90.050003,1231,118
1400000US06037536000,6037536000,2021,2286,2116,92.559998,1932,184
1400000US06037536103,6037536103,2021,519,456,87.860001,423,33
1400000US06037536104,6037536104,2021,1997,1761,88.18,1600,161
1400000US06037536201,6037536201,2021,895,762,85.139999,641,121
1400000US06037540000,6037540000,2021,2571,2380,92.57,2127,253
1400000US06037540101,6037540101,2021,3058,2896,94.699997,2547,349
1400000US06037540202,6037540202,2021,1798,1672,92.989998,1514,158
1400000US06037540203,6037540203,2021,529,484,91.489998,428,56
1400000US06037540300,6037540300,2021,375,352,93.870003,327,25
1400000US06037540400,6037540400,2021,308,299,97.080002,294,5
1400000US06037540502,6037540502,2021,636,611,96.07,570,41
1400000US06037540600,6037540600,2021,416,388,93.269997,378,10
1400000US06037540700,6037540700,2021,2322,2116,91.129997,1982,134
1400000US06037540800,6037540800,2021,1399,1236,88.349998,1162,74
1400000US06037540901,6037540901,2021,632,617,97.629997,599,18
1400000US06037540902,6037540902,2021,1269,1130,89.050003,1031,99
1400000US06037541003,6037541003,2021,532,392,73.68,355,37
1400000US06037541100,6037541100,2021,440,392,89.089996,351,41
1400000US06037541200,6037541200,2021,927,852,91.910004,784,68
1400000US06037541300,6037541300,2021,1441,1330,92.300003,1185,145
1400000US06037541401,6037541401,2021,506,465,91.900002,430,35
1400000US06037541500,6037541500,2021,738,662,89.699997,605,57
1400000US06037541603,6037541603,2021,902,804,89.139999,732,72
1400000US06037541605,6037541605,2021,544,502,92.279999,473,29
1400000US06037541700,6037541700,2021,3202,3042,95,2774,268
1400000US06037541802,6037541802,2021,551,513,93.099998,454,59
1400000US06037542000,6037542000,2021,1148,1036,90.239998,969,67
1400000US06037542104,6037542104,2021,585,550,94.019997,518,32
1400000US06037542106,6037542106,2021,3026,2747,90.779999,2553,194
1400000US06037542200,6037542200,2021,831,761,91.580002,710,51
1400000US06037542401,6037542401,2021,724,665,91.849998,624,41
1400000US06037542402,6037542402,2021,1998,1831,91.639999,1701,130
1400000US06037542601,6037542601,2021,535,468,87.480003,445,23
1400000US06037542700,6037542700,2021,1213,1080,89.040001,1031,49
1400000US06037542800,6037542800,2021,712,646,90.730003,594,52
1400000US06037542900,6037542900,2021,579,507,87.559998,448,59
1400000US06037543000,6037543000,2021,689,620,89.989998,557,63
1400000US06037543100,6037543100,2021,887,785,88.5,720,65
1400000US06037543201,6037543201,2021,637,580,91.050003,544,36
1400000US06037543203,6037543203,2021,241,217,90.040001,203,14
1400000US06037543304,6037543304,2021,252,226,89.68,210,16
1400000US06037543306,6037543306,2021,300,206,68.669998,187,19
1400000US06037543321,6037543321,2021,664,290,43.669998,231,59
1400000US06037543322,6037543322,2021,1293,1027,79.43,971,56
1400000US06037543400,6037543400,2021,290,236,81.379997,200,36
1400000US06037543501,6037543501,2021,1632,1245,76.290001,1084,161
1400000US06037543503,6037543503,2021,950,847,89.160004,787,60
1400000US06037543601,6037543601,2021,785,569,72.480003,483,86
1400000US06037543607,6037543607,2021,378,258,68.25,212,46
1400000US06037543701,6037543701,2021,2953,2224,75.309998,1902,322
1400000US06037543705,6037543705,2021,445,396,88.989998,365,31
1400000US06037543801,6037543801,2021,635,474,74.650002,428,46
1400000US06037543903,6037543903,2021,1131,888,78.510002,778,110
1400000US06037544001,6037544001,2021,468,405,86.540001,374,31
1400000US06037544002,6037544002,2021,758,550,72.559998,506,44
1400000US06037550101,6037550101,2021,314,224,71.339996,183,41
1400000US06037550201,6037550201,2021,237,179,75.529999,138,41
1400000US06037550202,6037550202,2021,369,255,69.110001,202,53
1400000US06037550301,6037550301,2021,441,287,65.080002,217,70
1400000US06037550501,6037550501,2021,689,424,61.540001,358,66
1400000US06037550602,6037550602,2021,733,395,53.889999,337,58
1400000US06037550700,6037550700,2021,2121,1262,59.5,1033,229
1400000US06037550801,6037550801,2021,796,518,65.080002,444,74
1400000US06037550901,6037550901,2021,4243,2496,58.830002,2035,461
1400000US06037551001,6037551001,2021,746,395,52.950001,342,53
1400000US06037551002,6037551002,2021,1353,828,61.200001,702,126
1400000US06037551101,6037551101,2021,599,451,75.290001,411,40
1400000US06037551102,6037551102,2021,231,149,64.5,140,9
1400000US06037551201,6037551201,2021,511,336,65.75,277,59
1400000US06037551203,6037551203,2021,1073,777,72.410004,656,121
1400000US06037551204,6037551204,2021,808,593,73.389999,500,93
1400000US06037551300,6037551300,2021,3430,2080,60.639999,1717,363
1400000US06037551402,6037551402,2021,672,431,64.139999,365,66
1400000US06037551501,6037551501,2021,2021,1395,69.029999,1147,248
1400000US06037551700,6037551700,2021,605,445,73.550003,400,45
1400000US06037551801,6037551801,2021,248,104,41.939999,74,30
1400000US06037551802,6037551802,2021,856,570,66.589996,487,83
1400000US06037551900,6037551900,2021,320,282,88.129997,263,19
1400000US06037552001,6037552001,2021,378,309,81.75,282,27
1400000US06037552100,6037552100,2021,3259,2531,77.660004,2342,189
1400000US06037552200,6037552200,2021,314,288,91.720001,276,12
1400000US06037552301,6037552301,2021,387,319,82.43,302,17
1400000US06037552302,6037552302,2021,1156,916,79.239998,862,54
1400000US06037552601,6037552601,2021,401,359,89.529999,344,15
1400000US06037552602,6037552602,2021,507,428,84.419998,404,24
1400000US06037552700,6037552700,2021,527,450,85.389999,427,23
1400000US06037552800,6037552800,2021,1908,1540,80.709999,1428,112
1400000US06037553000,6037553000,2021,476,403,84.660004,378,25
1400000US06037553100,6037553100,2021,2621,2016,76.919998,1737,279
1400000US06037553300,6037553300,2021,323,262,81.110001,230,32
1400000US06037553502,6037553502,2021,5226,4897,93.699997,4239,658
1400000US06037553504,6037553504,2021,549,495,90.160004,443,52
1400000US06037553601,6037553601,2021,477,456,95.599998,405,51
1400000US06037553701,6037553701,2021,467,432,92.510002,394,38
1400000US06037553702,6037553702,2021,1240,1167,94.110001,1064,103
1400000US06037553802,6037553802,2021,1119,1018,90.970001,896,122
1400000US06037553901,6037553901,2021,956,802,83.889999,685,117
1400000US06037553902,6037553902,2021,1456,1333,91.550003,1180,153
1400000US06037554002,6037554002,2021,639,533,83.410004,473,60
1400000US06037554106,6037554106,2021,481,391,81.290001,344,47
1400000US06037554201,6037554201,2021,582,496,85.220001,443,53
1400000US06037554405,6037554405,2021,672,494,73.510002,413,81
1400000US06037554511,6037554511,2021,1901,759,39.93,509,250
1400000US06037554512,6037554512,2021,1576,540,34.259998,353,187
1400000US06037554514,6037554514,2021,487,347,71.25,302,45
1400000US06037554515,6037554515,2021,755,378,50.07,272,106
1400000US06037554516,6037554516,2021,3938,1933,49.09,1330,603
1400000US06037554517,6037554517,2021,740,261,35.27,163,98
1400000US06037554518,6037554518,2021,634,218,34.380001,130,88
1400000US06037554521,6037554521,2021,1861,1197,64.32,917,280
1400000US06037554522,6037554522,2021,1148,707,61.59,538,169
1400000US06037554700,6037554700,2021,273,256,93.769997,250,6
1400000US06037554801,6037554801,2021,650,498,76.620003,396,102
1400000US06037554802,6037554802,2021,1478,1077,72.870003,823,254
1400000US06037555001,6037555001,2021,398,315,79.150002,286,29
1400000US06037555002,6037555002,2021,302,241,79.800003,210,31
1400000US06037555105,6037555105,2021,1924,1514,78.690002,1325,189
1400000US06037555106,6037555106,2021,384,365,95.050003,306,59
1400000US06037555107,6037555107,2021,420,387,92.139999,357,30
1400000US06037555211,6037555211,2021,339,296,87.32,279,17
1400000US06037555212,6037555212,2021,297,252,84.849998,244,8
1400000US06037555300,6037555300,2021,356,258,72.470001,187,71
1400000US06037570001,6037570001,2021,3408,2127,62.41,1697,430
1400000US06037570002,6037570002,2021,569,487,85.589996,442,45
1400000US06037570100,6037570100,2021,567,531,93.650002,485,46
1400000US06037570202,6037570202,2021,881,780,88.540001,706,74
1400000US06037570203,6037570203,2021,573,496,86.559998,465,31
1400000US06037570402,6037570402,2021,969,801,82.660004,739,62
1400000US06037570403,6037570403,2021,664,548,82.529999,496,52
1400000US06037570504,6037570504,2021,3182,2446,76.870003,2242,204
1400000US06037570601,6037570601,2021,505,435,86.139999,399,36
1400000US06037570602,6037570602,2021,853,705,82.650002,628,77
1400000US06037570701,6037570701,2021,903,719,79.620003,629,90
1400000US06037570800,6037570800,2021,1262,759,60.139999,580,179
1400000US06037570902,6037570902,2021,624,321,51.439999,278,43
1400000US06037571000,6037571000,2021,455,141,30.99,115,26
1400000US06037571101,6037571101,2021,334,162,48.5,149,13
1400000US06037571102,6037571102,2021,3114,1880,60.369999,1628,252
1400000US06037571202,6037571202,2021,1358,737,54.27,636,101
1400000US06037571300,6037571300,2021,1023,707,69.110001,625,82
1400000US06037571400,6037571400,2021,371,189,50.939999,160,29
1400000US06037571502,6037571502,2021,481,427,88.769997,392,35
1400000US06037571701,6037571701,2021,1631,1363,83.57,1264,99
1400000US06037571703,6037571703,2021,844,744,88.150002,666,78
1400000US06037571800,6037571800,2021,489,243,49.689999,197,46
1400000US06037571900,6037571900,2021,2359,1231,52.18,1092,139
1400000US06037572202,6037572202,2021,1393,1132,81.260002,1061,71
1400000US06037572500,6037572500,2021,528,430,81.440002,390,40
1400000US06037572600,6037572600,2021,736,590,80.160004,540,50
1400000US06037572700,6037572700,2021,629,480,76.309998,437,43
1400000US06037573101,6037573101,2021,903,722,79.959999,661,61
1400000US06037573201,6037573201,2021,727,608,83.629997,574,34
1400000US06037573300,6037573300,2021,368,274,74.459999,249,25
1400000US06037573402,6037573402,2021,1513,1249,82.550003,1157,92
1400000US06037573601,6037573601,2021,385,148,38.439999,120,28
1400000US06037573700,6037573700,2021,855,207,24.209999,168,39
1400000US06037573800,6037573800,2021,1156,481,41.610001,417,64
1400000US06037573902,6037573902,2021,759,145,19.1,118,27
1400000US06037574000,6037574000,2021,928,284,30.6,251,33
1400000US06037574100,6037574100,2021,1437,518,36.049999,431,87
1400000US06037574201,6037574201,2021,502,229,45.619999,197,32
1400000US06037574202,6037574202,2021,46,39,84.779999,38,1
1400000US06037574300,6037574300,2021,1755,629,35.84,536,93
1400000US06037574400,6037574400,2021,3772,1332,35.310001,1145,187
1400000US06037574500,6037574500,2021,726,293,40.360001,252,41
1400000US06037574602,6037574602,2021,418,138,33.009998,117,21
1400000US06037574901,6037574901,2021,568,138,24.299999,116,22
1400000US06037575001,6037575001,2021,402,301,74.879997,280,21
1400000US06037575002,6037575002,2021,310,223,71.940002,207,16
1400000US06037575101,6037575101,2021,758,659,86.940002,626,33
1400000US06037575201,6037575201,2021,745,620,83.220001,577,43
1400000US06037575300,6037575300,2021,4900,3341,68.18,3080,261
1400000US06037575401,6037575401,2021,1471,1186,80.629997,1143,43
1400000US06037575402,6037575402,2021,113,75,66.370003,74,1
1400000US06037575901,6037575901,2021,451,388,86.029999,368,20
1400000US06037576200,6037576200,2021,861,722,83.860001,664,58
1400000US06037576301,6037576301,2021,1105,797,72.129997,753,44
1400000US06037576401,6037576401,2021,893,802,89.809998,759,43
1400000US06037576501,6037576501,2021,1200,1042,86.830002,990,52
1400000US06037576801,6037576801,2021,642,528,82.239998,493,35
1400000US06037576903,6037576903,2021,584,453,77.57,430,23
1400000US06037577000,6037577000,2021,4711,2997,63.619999,2746,251
1400000US06037577100,6037577100,2021,785,419,53.380001,361,58
1400000US06037577501,6037577501,2021,311,84,27.01,74,10
1400000US06037577602,6037577602,2021,319,101,31.66,87,14
1400000US06037577606,6037577606,2021,1379,332,24.08,301,31
1400000US06037577700,6037577700,2021,985,739,75.029999,633,106
1400000US06037577800,6037577800,2021,549,422,76.870003,284,138
1400000US06037577900,6037577900,2021,450,278,61.779999,249,29
1400000US06037578000,6037578000,2021,2571,2052,79.809998,1891,161
1400000US06037599000,6037599000,2021,470,272,57.869999,241,31
1400000US06037600201,6037600201,2021,863,849,98.379997,833,16
1400000US06037600302,6037600302,2021,1833,1747,95.309998,1713,34
1400000US06037600303,6037600303,2021,647,635,98.150002,623,12
1400000US06037600501,6037600501,2021,252,236,93.650002,228,8
1400000US06037600602,6037600602,2021,1210,1023,84.550003,987,36
1400000US06037600702,6037600702,2021,340,293,86.18,259,34
1400000US06037600703,6037600703,2021,605,561,92.730003,491,70
1400000US06037600801,6037600801,2021,143,112,78.32,110,2
1400000US06037600911,6037600911,2021,523,467,89.290001,443,24
1400000US06037601001,6037601001,2021,70,70,100,70,0
1400000US06037601002,6037601002,2021,395,357,90.379997,341,16
1400000US06037601202,6037601202,2021,1091,853,78.190002,799,54
1400000US06037601211,6037601211,2021,1469,1337,91.010002,1270,67
1400000US06037601212,6037601212,2021,408,371,90.93,335,36
1400000US06037601301,6037601301,2021,728,538,73.900002,508,30
1400000US06037601303,6037601303,2021,1050,813,77.43,716,97
1400000US06037601401,6037601401,2021,406,353,86.949997,337,16
1400000US06037601402,6037601402,2021,483,444,91.93,416,28
1400000US06037601502,6037601502,2021,1301,1300,99.919998,1177,123
1400000US06037601600,6037601600,2021,2057,2002,97.330002,1790,212
1400000US06037601700,6037601700,2021,1973,1858,94.169998,1622,236
1400000US06037601802,6037601802,2021,549,548,99.82,502,46
1400000US06037602003,6037602003,2021,395,349,88.349998,332,17
1400000US06037602104,6037602104,2021,457,416,91.029999,341,75
1400000US06037602106,6037602106,2021,1380,1202,87.099998,974,228
1400000US06037602201,6037602201,2021,3356,1914,57.029999,1721,193
1400000US06037602302,6037602302,2021,1872,606,32.369999,490,116
1400000US06037602402,6037602402,2021,775,567,73.160004,464,103
1400000US06037602403,6037602403,2021,1340,1156,86.269997,960,196
1400000US06037602404,6037602404,2021,503,466,92.639999,381,85
1400000US06037602505,6037602505,2021,762,715,93.830002,584,131
1400000US06037602506,6037602506,2021,724,650,89.779999,508,142
1400000US06037602511,6037602511,2021,1568,1456,92.860001,1230,226
1400000US06037602601,6037602601,2021,415,379,91.330002,363,16
1400000US06037602700,6037602700,2021,281,233,82.919998,220,13
1400000US06037602801,6037602801,2021,1139,1103,96.839996,1003,100
1400000US06037602802,6037602802,2021,954,875,91.720001,812,63
1400000US06037603006,6037603006,2021,369,325,88.080002,306,19
1400000US06037603008,6037603008,2021,746,683,91.550003,632,51
1400000US06037603200,6037603200,2021,1457,1346,92.379997,1244,102
1400000US06037603301,6037603301,2021,1883,1529,81.199997,1452,77
1400000US06037603400,6037603400,2021,736,532,72.279999,462,70
1400000US06037603702,6037603702,2021,541,398,73.57,343,55
1400000US06037603705,6037603705,2021,179,132,73.739998,130,2
1400000US06037603706,6037603706,2021,518,470,90.730003,430,40
1400000US06037603801,6037603801,2021,1816,1432,78.849998,1351,81
1400000US06037603802,6037603802,2021,1538,1374,89.339996,1221,153
1400000US06037603901,6037603901,2021,3075,2507,81.529999,2249,258
1400000US06037603902,6037603902,2021,846,733,86.639999,637,96
1400000US06037604001,6037604001,2021,506,406,80.239998,360,46
1400000US06037604002,6037604002,2021,598,548,91.639999,485,63
1400000US06037604200,6037604200,2021,797,706,88.580002,638,68
1400000US06037620001,6037620001,2021,745,79,10.6,64,15
1400000US06037620002,6037620002,2021,796,122,15.33,101,21
1400000US06037620101,6037620101,2021,1856,277,14.92,247,30
1400000US06037620303,6037620303,2021,538,16,2.97,16,0
1400000US06037620305,6037620305,2021,519,12,2.3099999,12,0
1400000US06037620400,6037620400,2021,1718,71,4.1300001,71,0
1400000US06037620501,6037620501,2021,613,70,11.42,63,7
1400000US06037620521,6037620521,2021,422,76,18.01,68,8
1400000US06037620602,6037620602,2021,1880,371,19.73,326,45
1400000US06037620701,6037620701,2021,467,43,9.21,42,1
1400000US06037620703,6037620703,2021,554,30,5.4200001,29,1
1400000US06037620802,6037620802,2021,2788,142,5.0900002,139,3
1400000US06037620904,6037620904,2021,301,13,4.3200002,13,0
1400000US06037621005,6037621005,2021,1190,63,5.29,62,1
1400000US06037621201,6037621201,2021,4668,736,15.77,669,67
1400000US06037621301,6037621301,2021,581,54,9.29,48,6
1400000US06037621400,6037621400,2021,416,49,11.78,46,3
1400000US06037650001,6037650001,2021,1089,389,35.720001,312,77
1400000US06037650004,6037650004,2021,296,157,53.040001,144,13
1400000US06037650101,6037650101,2021,549,189,34.43,155,34
1400000US06037650200,6037650200,2021,2499,1046,41.860001,874,172
1400000US06037650300,6037650300,2021,543,247,45.490002,210,37
1400000US06037650401,6037650401,2021,1200,388,32.330002,320,68
1400000US06037650502,6037650502,2021,1218,220,18.059999,196,24
1400000US06037650603,6037650603,2021,2862,678,23.690001,589,89
1400000US06037650701,6037650701,2021,667,178,26.690001,154,24
1400000US06037650702,6037650702,2021,608,62,10.2,53,9
1400000US06037650903,6037650903,2021,1880,629,33.459999,524,105
1400000US06037650904,6037650904,2021,553,336,60.759998,296,40
1400000US06037651001,6037651001,2021,694,339,48.849998,301,38
1400000US06037651002,6037651002,2021,774,285,36.82,260,25
1400000US06037651101,6037651101,2021,882,153,17.35,134,19
1400000US06037651201,6037651201,2021,497,66,13.28,58,8
1400000US06037651221,6037651221,2021,658,127,19.299999,110,17
1400000US06037651222,6037651222,2021,2581,521,20.190001,430,91
1400000US06037651302,6037651302,2021,1302,199,15.28,171,28
1400000US06037651402,6037651402,2021,646,102,15.79,91,11
1400000US06037670002,6037670002,2021,1208,1056,87.419998,999,57
1400000US06037670003,6037670003,2021,857,620,72.349998,545,75
1400000US06037670101,6037670101,2021,427,386,90.400002,368,18
1400000US06037670202,6037670202,2021,346,44,12.72,42,2
1400000US06037670324,6037670324,2021,637,37,5.8099999,37,0
1400000US06037670326,6037670326,2021,409,20,4.8899999,20,0
1400000US06037670328,6037670328,2021,2522,143,5.6700001,138,5
1400000US06037670405,6037670405,2021,873,80,9.1599998,77,3
1400000US06037670413,6037670413,2021,381,26,6.8200002,26,0
1400000US06037670416,6037670416,2021,294,21,7.1399999,19,2
1400000US06037670417,6037670417,2021,2699,227,8.4099998,216,11
1400000US06037670418,6037670418,2021,892,43,4.8200002,40,3
1400000US06037670500,6037670500,2021,28,4,14.29,4,0
1400000US06037670604,6037670604,2021,363,21,5.79,21,0
1400000US06037670701,6037670701,2021,1955,1159,59.279999,995,164
1400000US06037670702,6037670702,2021,786,68,8.6499996,65,3
1400000US06037700200,6037700200,2021,1814,870,47.959999,757,113
1400000US06037700400,6037700400,2021,299,157,52.509998,139,18
1400000US06037700501,6037700501,2021,361,86,23.82,78,8
1400000US06037700600,6037700600,2021,546,50,9.1599998,49,1
1400000US06037700901,6037700901,2021,598,115,19.23,110,5
1400000US06037700902,6037700902,2021,876,140,15.98,136,4
1400000US06037701000,6037701000,2021,1214,212,17.459999,201,11
1400000US06037701304,6037701304,2021,663,75,11.31,68,7
1400000US06037701501,6037701501,2021,1054,184,17.459999,161,23
1400000US06037701601,6037701601,2021,664,38,5.7199998,36,2
1400000US06037701602,6037701602,2021,407,116,28.5,105,11
1400000US06037701801,6037701801,2021,418,146,34.93,127,19
1400000US06037701902,6037701902,2021,2786,679,24.370001,610,69
1400000US06037702002,6037702002,2021,533,142,26.639999,129,13
1400000US06037702201,6037702201,2021,1410,453,32.130001,391,62
1400000US06037702300,6037702300,2021,560,141,25.18,121,20
1400000US06037702400,6037702400,2021,618,154,24.92,140,14
1400000US06037702600,6037702600,2021,1407,217,15.42,200,17
1400000US06037702700,6037702700,2021,4388,1200,27.35,1083,117
1400000US06037702801,6037702801,2021,550,244,44.360001,233,11
1400000US06037702803,6037702803,2021,554,357,64.440002,330,27
1400000US06037703002,6037703002,2021,435,284,65.290001,259,25
1400000US06037703100,6037703100,2021,446,367,82.290001,357,10
1400000US06037703200,6037703200,2021,291,265,91.07,262,3
1400000US06037800101,6037800101,2021,3121,310,9.9300003,302,8
1400000US06037800103,6037800103,2021,212,39,18.4,37,2
1400000US06037800202,6037800202,2021,1202,155,12.9,150,5
1400000US06037800205,6037800205,2021,504,99,19.639999,97,2
1400000US06037800206,6037800206,2021,488,31,6.3499999,25,6
1400000US06037800325,6037800325,2021,384,28,7.29,25,3
1400000US06037800334,6037800334,2021,2511,371,14.77,357,14
1400000US06037800338,6037800338,2021,1835,199,10.84,181,18
1400000US06037800406,6037800406,2021,25,25,100,25,0
1400000US06037800411,6037800411,2021,799,99,12.39,94,5
1400000US06037800412,6037800412,2021,221,33,14.93,29,4
1400000US06037800504,6037800504,2021,234,22,9.3999996,21,1
1400000US06037900102,6037900102,2021,647,599,92.580002,562,37
1400000US06037900103,6037900103,2021,549,525,95.629997,499,26
1400000US06037900104,6037900104,2021,513,478,93.18,433,45
1400000US06037900301,6037900301,2021,731,698,95.489998,678,20
1400000US06037900501,6037900501,2021,556,541,97.300003,498,43
1400000US06037900504,6037900504,2021,4507,3674,81.519997,3351,323
1400000US06037900505,6037900505,2021,616,579,93.989998,521,58
1400000US06037900508,6037900508,2021,2581,2027,78.540001,1830,197
1400000US06037900510,6037900510,2021,1306,1223,93.639999,1185,38
1400000US06037900602,6037900602,2021,880,836,95,772,64
1400000US06037900606,6037900606,2021,2761,2373,85.949997,2216,157
1400000US06037900607,6037900607,2021,704,665,94.459999,620,45
1400000US06037900609,6037900609,2021,751,665,88.550003,592,73
1400000US06037900610,6037900610,2021,601,565,94.010002,553,12
1400000US06037900701,6037900701,2021,998,884,88.580002,817,67
1400000US06037900703,6037900703,2021,1258,1097,87.199997,989,108
1400000US06037900804,6037900804,2021,595,560,94.120003,504,56
1400000US06037900805,6037900805,2021,722,658,91.139999,581,77
1400000US06037900807,6037900807,2021,667,627,94,561,66
1400000US06037900901,6037900901,2021,784,371,47.32,273,98
1400000US06037901007,6037901007,2021,689,427,61.970001,362,65
1400000US06037901009,6037901009,2021,888,783,88.18,642,141
1400000US06037901010,6037901010,2021,726,599,82.510002,463,136
1400000US06037901011,6037901011,2021,695,599,86.190002,498,101
1400000US06037901012,6037901012,2021,787,628,79.800003,505,123
1400000US06037901013,6037901013,2021,1172,762,65.019997,601,161
1400000US06037901014,6037901014,2021,2524,1561,61.849998,1396,165
1400000US06037901101,6037901101,2021,963,459,47.66,362,97
1400000US06037901209,6037901209,2021,302,159,52.650002,154,5
1400000US06037901214,6037901214,2021,887,492,55.470001,378,114
1400000US06037901215,6037901215,2021,3407,1611,47.290001,1284,327
1400000US06037901217,6037901217,2021,54,14,25.93,9,5
1400000US06037901300,6037901300,2021,506,485,95.849998,476,9
1400000US06037910002,6037910002,2021,214,170,79.440002,139,31
1400000US06037910210,6037910210,2021,1002,496,49.5,374,122
1400000US06037910212,6037910212,2021,832,212,25.48,171,41
1400000US06037910214,6037910214,2021,4229,2901,68.599998,2481,420
1400000US06037910215,6037910215,2021,1626,1277,78.540001,1079,198
1400000US06037910217,6037910217,2021,684,389,56.869999,300,89
1400000US06037910218,6037910218,2021,457,322,70.459999,299,23
1400000US06037910301,6037910301,2021,810,492,60.740002,422,70
1400000US06037910302,6037910302,2021,1845,869,47.099998,670,199
1400000US06037910401,6037910401,2021,649,551,84.900002,439,112
1400000US06037910404,6037910404,2021,526,485,92.209999,437,48
1400000US06037910405,6037910405,2021,1354,1171,86.480003,1068,103
1400000US06037910504,6037910504,2021,656,648,98.779999,632,16
1400000US06037910601,6037910601,2021,598,543,90.800003,496,47
1400000US06037910602,6037910602,2021,5671,4640,81.82,4207,433
1400000US06037910605,6037910605,2021,866,806,93.07,688,118
1400000US06037910606,6037910606,2021,260,212,81.540001,193,19
1400000US06037910608,6037910608,2021,622,605,97.269997,555,50
1400000US06037910706,6037910706,2021,713,635,89.059998,539,96
1400000US06037910712,6037910712,2021,502,432,86.059998,356,76
1400000US06037910714,6037910714,2021,1709,1483,86.779999,1332,151
1400000US06037910715,6037910715,2021,531,493,92.839996,443,50
1400000US06037910716,6037910716,2021,1606,1418,88.290001,1240,178
1400000US06037910717,6037910717,2021,4438,3355,75.599998,2770,585
1400000US06037910718,6037910718,2021,1457,1361,93.410004,1149,212
1400000US06037910720,6037910720,2021,681,614,90.160004,537,77
1400000US06037910804,6037910804,2021,3835,1312,34.209999,1202,110
1400000US06037910807,6037910807,2021,989,511,51.669998,425,86
1400000US06037910814,6037910814,2021,273,105,38.459999,101,4
1400000US06037910815,6037910815,2021,1255,753,60,650,103
1400000US06037911001,6037911001,2021,911,792,86.940002,705,87
1400000US06037911100,6037911100,2021,2354,1978,84.029999,1738,240
1400000US06037920013,6037920013,2021,511,57,11.15,56,1
1400000US06037920015,6037920015,2021,588,93,15.82,54,39
1400000US06037920017,6037920017,2021,3513,844,24.030001,671,173
1400000US06037920020,6037920020,2021,475,105,22.110001,90,15
1400000US06037920029,6037920029,2021,2377,1099,46.23,957,142
1400000US06037920031,6037920031,2021,3126,1585,50.700001,1441,144
1400000US06037920034,6037920034,2021,977,527,53.939999,436,91
1400000US06037920035,6037920035,2021,480,414,86.25,358,56
1400000US06037920041,6037920041,2021,2003,712,35.549999,619,93
1400000US06037920042,6037920042,2021,551,368,66.790001,325,43
1400000US06037920043,6037920043,2021,1458,504,34.57,377,127
1400000US06037920044,6037920044,2021,2451,473,19.299999,438,35
1400000US06037920048,6037920048,2021,1663,859,51.650002,778,81
1400000US06037920049,6037920049,2021,457,92,20.129999,55,37
1400000US06037920102,6037920102,2021,702,305,43.450001,280,25
1400000US06037920104,6037920104,2021,731,203,27.77,181,22
1400000US06037920109,6037920109,2021,413,48,11.62,46,2
1400000US06037920111,6037920111,2021,224,66,29.459999,57,9
1400000US06037920112,6037920112,2021,1213,219,18.049999,204,15
1400000US06037920115,6037920115,2021,850,176,20.709999,154,22
1400000US06037920118,6037920118,2021,1818,537,29.540001,498,39
1400000US06037920119,6037920119,2021,414,69,16.67,62,7
1400000US06037920120,6037920120,2021,373,72,19.299999,58,14
1400000US06037920121,6037920121,2021,4752,869,18.290001,764,105
1400000US06037920313,6037920313,2021,669,458,68.459999,400,58
1400000US06037920314,6037920314,2021,477,186,38.990002,176,10
1400000US06037920322,6037920322,2021,368,167,45.380001,138,29
1400000US06037920326,6037920326,2021,1040,182,17.5,160,22
1400000US06037920329,6037920329,2021,680,177,26.030001,168,9
1400000US06037920330,6037920330,2021,411,59,14.36,52,7
1400000US06037920334,6037920334,2021,523,101,19.309999,78,23
1400000US06037920338,6037920338,2021,486,32,6.5799999,27,5
1400000US06037920339,6037920339,2021,3438,553,16.08,482,71
1400000US06037920340,6037920340,2021,3097,1288,41.59,1226,62
1400000US06037920341,6037920341,2021,908,624,68.720001,563,61
1400000US06037920342,6037920342,2021,949,623,65.650002,535,88
1400000US06037930400,6037930400,2021,87,28,32.18,28,0
1400000US06037980004,6037980004,2021,700,690,98.57,654,36
1400000US06037980013,6037980013,2021,1228,479,39.009998,418,61
1400000US06037980016,6037980016,2021,182,176,96.699997,172,4
1400000US06037101110,6037101110,2020,1239,965,77.889999,778,187
1400000US06037101220,6037101220,2020,186,174,93.550003,159,15
1400000US06037101300,6037101300,2020,414,284,68.599998,223,61
1400000US06037102107,6037102107,2020,824,638,77.43,509,129
1400000US06037103101,6037103101,2020,857,716,83.550003,643,73
1400000US06037103102,6037103102,2020,644,532,82.610001,478,54
1400000US06037103202,6037103202,2020,158,123,77.849998,106,17
1400000US06037103402,6037103402,2020,410,239,58.290001,191,48
1400000US06037104103,6037104103,2020,633,542,85.620003,433,109
1400000US06037104105,6037104105,2020,962,842,87.529999,727,115
1400000US06037104108,6037104108,2020,1197,1136,94.900002,1067,69
1400000US06037104124,6037104124,2020,1158,1002,86.529999,817,185
1400000US06037104204,6037104204,2020,412,402,97.57,383,19
1400000US06037104310,6037104310,2020,3018,2943,97.510002,2599,344
1400000US06037104321,6037104321,2020,1180,1013,85.849998,939,74
1400000US06037104401,6037104401,2020,634,560,88.330002,536,24
1400000US06037104500,6037104500,2020,730,649,88.900002,607,42
1400000US06037104821,6037104821,2020,802,711,88.650002,634,77
1400000US06037104822,6037104822,2020,1114,999,89.68,917,82
1400000US06037106020,6037106020,2020,244,196,80.330002,195,1
1400000US06037106112,6037106112,2020,555,469,84.5,422,47
1400000US06037106113,6037106113,2020,374,273,72.989998,216,57
1400000US06037106114,6037106114,2020,396,345,87.120003,312,33
1400000US06037106403,6037106403,2020,2103,1832,87.110001,1659,173
1400000US06037106405,6037106405,2020,2552,2185,85.620003,1987,198
1400000US06037106510,6037106510,2020,220,220,100,220,0
1400000US06037106520,6037106520,2020,1656,1446,87.32,1234,212
1400000US06037106603,6037106603,2020,444,204,45.950001,161,43
1400000US06037106604,6037106604,2020,396,320,80.809998,303,17
1400000US06037106641,6037106641,2020,1576,851,54,644,207
1400000US06037106642,6037106642,2020,445,123,27.639999,101,22
1400000US06037106646,6037106646,2020,2703,1975,73.07,1559,416
1400000US06037106648,6037106648,2020,345,283,82.029999,258,25
1400000US06037107020,6037107020,2020,639,594,92.959999,540,54
1400000US06037108104,6037108104,2020,697,132,18.940001,106,26
1400000US06037108202,6037108202,2020,1217,203,16.68,183,20
1400000US06037109200,6037109200,2020,318,244,76.730003,194,50
1400000US06037109300,6037109300,2020,579,403,69.599998,309,94
1400000US06037109500,6037109500,2020,2051,1886,91.959999,1733,153
1400000US06037109601,6037109601,2020,643,465,72.32,377,88
1400000US06037109700,6037109700,2020,1286,885,68.82,680,205
1400000US06037109800,6037109800,2020,800,467,58.380001,328,139
1400000US06037111100,6037111100,2020,449,319,71.050003,255,64
1400000US06037111202,6037111202,2020,403,280,69.480003,223,57
1400000US06037111204,6037111204,2020,2879,1273,44.220001,962,311
1400000US06037111206,6037111206,2020,428,229,53.5,181,48
1400000US06037111302,6037111302,2020,406,282,69.459999,223,59
1400000US06037111303,6037111303,2020,2313,1524,65.889999,1216,308
1400000US06037111304,6037111304,2020,5030,2591,51.509998,1891,700
1400000US06037111401,6037111401,2020,470,308,65.529999,254,54
1400000US06037113101,6037113101,2020,522,330,63.220001,274,56
1400000US06037113212,6037113212,2020,414,250,60.389999,217,33
1400000US06037113232,6037113232,2020,337,284,84.269997,255,29
1400000US06037113303,6037113303,2020,557,355,63.73,306,49
1400000US06037113322,6037113322,2020,452,116,25.66,99,17
1400000US06037113323,6037113323,2020,1378,861,62.48,729,132
1400000US06037113324,6037113324,2020,1660,1137,68.489998,969,168
1400000US06037113423,6037113423,2020,148,106,71.620003,96,10
1400000US06037113428,6037113428,2020,733,666,90.860001,623,43
1400000US06037115101,6037115101,2020,2477,1396,56.360001,1142,254
1400000US06037115103,6037115103,2020,953,666,69.879997,578,88
1400000US06037115202,6037115202,2020,479,321,67.010002,260,61
1400000US06037115301,6037115301,2020,557,189,33.93,155,34
1400000US06037115302,6037115302,2020,430,398,92.559998,377,21
1400000US06037115401,6037115401,2020,820,717,87.440002,668,49
1400000US06037115403,6037115403,2020,285,216,75.790001,189,27
1400000US06037115404,6037115404,2020,216,56,25.93,53,3
1400000US06037117101,6037117101,2020,2923,2650,90.660004,2493,157
1400000US06037117102,6037117102,2020,418,376,89.949997,336,40
1400000US06037117202,6037117202,2020,2350,2042,86.889999,1904,138
1400000US06037117302,6037117302,2020,520,471,90.580002,420,51
1400000US06037117303,6037117303,2020,274,69,25.18,69,0
1400000US06037117407,6037117407,2020,586,574,97.949997,560,14
1400000US06037117510,6037117510,2020,504,477,94.639999,421,56
1400000US06037117520,6037117520,2020,592,565,95.440002,543,22
1400000US06037117530,6037117530,2020,763,715,93.709999,671,44
1400000US06037119003,6037119003,2020,584,507,86.82,485,22
1400000US06037119004,6037119004,2020,574,487,84.839996,404,83
1400000US06037119201,6037119201,2020,1740,1549,89.019997,1404,145
1400000US06037119342,6037119342,2020,600,523,87.169998,495,28
1400000US06037119802,6037119802,2020,746,627,84.050003,543,84
1400000US06037119900,6037119900,2020,876,767,87.559998,670,97
1400000US06037120010,6037120010,2020,1214,1182,97.360001,1141,41
1400000US06037120020,6037120020,2020,682,664,97.360001,640,24
1400000US06037120030,6037120030,2020,1560,1489,95.449997,1427,62
1400000US06037120107,6037120107,2020,485,468,96.489998,452,16
1400000US06037120108,6037120108,2020,876,852,97.260002,823,29
1400000US06037120300,6037120300,2020,301,275,91.360001,262,13
1400000US06037120400,6037120400,2020,455,391,85.93,364,27
1400000US06037121010,6037121010,2020,3897,3495,89.68,3151,344
1400000US06037121020,6037121020,2020,499,450,90.18,396,54
1400000US06037121102,6037121102,2020,308,253,82.139999,214,39
1400000US06037121210,6037121210,2020,370,286,77.300003,260,26
1400000US06037121222,6037121222,2020,2366,2186,92.389999,2047,139
1400000US06037121600,6037121600,2020,69,54,78.260002,43,11
1400000US06037121801,6037121801,2020,378,319,84.389999,306,13
1400000US06037121900,6037121900,2020,414,375,90.580002,353,22
1400000US06037122000,6037122000,2020,574,498,86.760002,473,25
1400000US06037122122,6037122122,2020,546,514,94.139999,474,40
1400000US06037122200,6037122200,2020,237,211,89.029999,197,14
1400000US06037122420,6037122420,2020,487,464,95.279999,436,28
1400000US06037123010,6037123010,2020,1831,1723,94.099998,1603,120
1400000US06037123301,6037123301,2020,458,435,94.980003,408,27
1400000US06037123303,6037123303,2020,656,604,92.07,562,42
1400000US06037123420,6037123420,2020,1650,1469,89.029999,1384,85
1400000US06037123510,6037123510,2020,758,682,89.970001,656,26
1400000US06037123601,6037123601,2020,1984,1900,95.769997,1750,150
1400000US06037123602,6037123602,2020,633,551,87.050003,506,45
1400000US06037123700,6037123700,2020,664,522,78.610001,455,67
1400000US06037123901,6037123901,2020,1912,1753,91.68,1655,98
1400000US06037124102,6037124102,2020,702,611,87.040001,564,47
1400000US06037124201,6037124201,2020,720,681,94.580002,621,60
1400000US06037124300,6037124300,2020,345,316,91.589996,300,16
1400000US06037124600,6037124600,2020,1715,907,52.889999,747,160
1400000US06037124700,6037124700,2020,498,166,33.330002,147,19
1400000US06037124902,6037124902,2020,365,260,71.230003,231,29
1400000US06037125101,6037125101,2020,2568,1728,67.290001,1476,252
1400000US06037125102,6037125102,2020,634,147,23.190001,130,17
1400000US06037125310,6037125310,2020,788,511,64.849998,472,39
1400000US06037125322,6037125322,2020,335,294,87.760002,282,12
1400000US06037125600,6037125600,2020,445,301,67.639999,257,44
1400000US06037127210,6037127210,2020,2638,2345,88.889999,2216,129
1400000US06037127400,6037127400,2020,500,447,89.400002,425,22
1400000US06037127603,6037127603,2020,641,615,95.940002,579,36
1400000US06037127803,6037127803,2020,325,192,59.080002,157,35
1400000US06037127805,6037127805,2020,452,372,82.300003,360,12
1400000US06037127806,6037127806,2020,2588,2200,85.010002,1984,216
1400000US06037127910,6037127910,2020,1127,782,69.389999,712,70
1400000US06037127920,6037127920,2020,701,626,89.300003,578,48
1400000US06037128102,6037128102,2020,876,754,86.07,721,33
1400000US06037128302,6037128302,2020,729,701,96.160004,654,47
1400000US06037128602,6037128602,2020,489,220,44.990002,192,28
1400000US06037128802,6037128802,2020,2157,1462,67.779999,1296,166
1400000US06037128910,6037128910,2020,183,93,50.82,79,14
1400000US06037131022,6037131022,2020,387,346,89.410004,328,18
1400000US06037131023,6037131023,2020,388,337,86.860001,312,25
1400000US06037131100,6037131100,2020,428,339,79.209999,291,48
1400000US06037131200,6037131200,2020,497,346,69.620003,281,65
1400000US06037131300,6037131300,2020,394,380,96.449997,366,14
1400000US06037131600,6037131600,2020,3335,2243,67.260002,1974,269
1400000US06037131701,6037131701,2020,58,33,56.900002,25,8
1400000US06037131801,6037131801,2020,995,893,89.75,809,84
1400000US06037131900,6037131900,2020,354,308,87.010002,281,27
1400000US06037132001,6037132001,2020,380,295,77.629997,246,49
1400000US06037132002,6037132002,2020,6439,5316,82.559998,4677,639
1400000US06037132301,6037132301,2020,351,300,85.470001,265,35
1400000US06037132501,6037132501,2020,6,3,50,2,1
1400000US06037132700,6037132700,2020,1941,1638,84.389999,1500,138
1400000US06037133000,6037133000,2020,389,336,86.379997,303,33
1400000US06037133101,6037133101,2020,407,369,90.660004,345,24
1400000US06037133102,6037133102,2020,2104,1144,54.369999,907,237
1400000US06037134001,6037134001,2020,693,669,96.540001,645,24
1400000US06037134002,6037134002,2020,471,274,58.169998,236,38
1400000US06037134101,6037134101,2020,398,340,85.43,319,21
1400000US06037134103,6037134103,2020,470,412,87.660004,395,17
1400000US06037134104,6037134104,2020,428,386,90.190002,351,35
1400000US06037134302,6037134302,2020,412,304,73.790001,256,48
1400000US06037134303,6037134303,2020,576,552,95.830002,513,39
1400000US06037134304,6037134304,2020,1117,995,89.080002,935,60
1400000US06037134421,6037134421,2020,591,170,28.76,145,25
1400000US06037134422,6037134422,2020,244,141,57.790001,115,26
1400000US06037134423,6037134423,2020,400,163,40.75,130,33
1400000US06037134520,6037134520,2020,1426,1222,85.690002,1135,87
1400000US06037134522,6037134522,2020,705,631,89.5,610,21
1400000US06037134720,6037134720,2020,1616,1450,89.730003,1321,129
1400000US06037134801,6037134801,2020,439,374,85.190002,351,23
1400000US06037135102,6037135102,2020,322,167,51.860001,136,31
1400000US06037135202,6037135202,2020,794,145,18.26,117,28
1400000US06037135204,6037135204,2020,874,217,24.83,188,29
1400000US06037137000,6037137000,2020,3450,1219,35.330002,999,220
1400000US06037137104,6037137104,2020,633,482,76.150002,450,32
1400000US06037137203,6037137203,2020,605,253,41.82,245,8
1400000US06037137301,6037137301,2020,565,190,33.630001,170,20
1400000US06037137302,6037137302,2020,2149,781,36.34,642,139
1400000US06037137401,6037137401,2020,636,120,18.870001,101,19
1400000US06037137402,6037137402,2020,421,90,21.379999,72,18
1400000US06037137501,6037137501,2020,2961,1637,55.290001,1351,286
1400000US06037139001,6037139001,2020,320,104,32.5,79,25
1400000US06037139200,6037139200,2020,301,191,63.459999,156,35
1400000US06037139301,6037139301,2020,641,442,68.949997,388,54
1400000US06037139402,6037139402,2020,3094,1196,38.66,993,203
1400000US06037139502,6037139502,2020,510,310,60.779999,258,52
1400000US06037139600,6037139600,2020,590,140,23.73,128,12
1400000US06037139701,6037139701,2020,560,46,8.21,39,7
1400000US06037141101,6037141101,2020,737,185,25.1,160,25
1400000US06037141304,6037141304,2020,744,209,28.09,195,14
1400000US06037141400,6037141400,2020,529,93,17.58,88,5
1400000US06037143200,6037143200,2020,848,507,59.790001,452,55
1400000US06037143302,6037143302,2020,1678,877,52.259998,756,121
1400000US06037143700,6037143700,2020,213,52,24.41,45,7
1400000US06037143801,6037143801,2020,978,114,11.66,107,7
1400000US06037181000,6037181000,2020,518,477,92.080002,401,76
1400000US06037181400,6037181400,2020,783,367,46.869999,279,88
1400000US06037181500,6037181500,2020,862,379,43.970001,316,63
1400000US06037181600,6037181600,2020,2241,1169,52.16,890,279
1400000US06037183101,6037183101,2020,1393,1155,82.910004,1057,98
1400000US06037183104,6037183104,2020,263,207,78.709999,169,38
1400000US06037183220,6037183220,2020,219,193,88.129997,177,16
1400000US06037183221,6037183221,2020,35,35,100,35,0
1400000US06037183401,6037183401,2020,289,239,82.699997,209,30
1400000US06037183402,6037183402,2020,294,244,82.989998,218,26
1400000US06037183510,6037183510,2020,1433,1274,88.900002,1143,131
1400000US06037183520,6037183520,2020,278,254,91.370003,236,18
1400000US06037183702,6037183702,2020,180,156,86.669998,139,17
1400000US06037183810,6037183810,2020,449,412,91.760002,379,33
1400000US06037185101,6037185101,2020,515,386,74.949997,357,29
1400000US06037185102,6037185102,2020,437,323,73.910004,287,36
1400000US06037185204,6037185204,2020,448,73,16.290001,61,12
1400000US06037185310,6037185310,2020,1109,988,89.089996,939,49
1400000US06037186100,6037186100,2020,487,290,59.549999,211,79
1400000US06037186401,6037186401,2020,1852,1604,86.610001,1463,141
1400000US06037186404,6037186404,2020,292,272,93.150002,257,15
1400000US06037187101,6037187101,2020,289,200,69.199997,174,26
1400000US06037187102,6037187102,2020,1331,778,58.450001,655,123
1400000US06037187300,6037187300,2020,348,271,77.870003,219,52
1400000US06037188201,6037188201,2020,467,58,12.42,43,15
1400000US06037188300,6037188300,2020,248,175,70.559998,155,20
1400000US06037189201,6037189201,2020,441,366,82.989998,334,32
1400000US06037189501,6037189501,2020,255,178,69.800003,163,15
1400000US06037189905,6037189905,2020,361,196,54.290001,177,19
1400000US06037190102,6037190102,2020,1416,1207,85.239998,1170,37
1400000US06037190510,6037190510,2020,457,392,85.779999,377,15
1400000US06037190701,6037190701,2020,104,91,87.5,86,5
1400000US06037190901,6037190901,2020,1239,1200,96.849998,1136,64
1400000US06037190902,6037190902,2020,886,828,93.449997,782,46
1400000US06037191120,6037191120,2020,361,351,97.230003,331,20
1400000US06037191204,6037191204,2020,410,349,85.120003,344,5
1400000US06037191301,6037191301,2020,114,106,92.980003,99,7
1400000US06037191410,6037191410,2020,375,368,98.129997,334,34
1400000US06037191720,6037191720,2020,854,814,95.32,715,99
1400000US06037191810,6037191810,2020,363,318,87.599998,307,11
1400000US06037191901,6037191901,2020,656,610,92.989998,574,36
1400000US06037192001,6037192001,2020,456,223,48.900002,180,43
1400000US06037192002,6037192002,2020,1749,1366,78.099998,1198,168
1400000US06037192410,6037192410,2020,197,160,81.220001,150,10
1400000US06037192520,6037192520,2020,333,299,89.790001,280,19
1400000US06037192620,6037192620,2020,575,540,93.910004,507,33
1400000US06037192700,6037192700,2020,357,330,92.440002,313,17
1400000US06037194300,6037194300,2020,490,53,10.82,44,9
1400000US06037195201,6037195201,2020,2703,1745,64.559998,1439,306
1400000US06037195300,6037195300,2020,2098,1454,69.300003,1260,194
1400000US06037195400,6037195400,2020,406,179,44.09,159,20
1400000US06037195500,6037195500,2020,184,155,84.239998,142,13
1400000US06037195710,6037195710,2020,869,788,90.68,748,40
1400000US06037197200,6037197200,2020,259,211,81.470001,178,33
1400000US06037197300,6037197300,2020,308,179,58.119999,162,17
1400000US06037197410,6037197410,2020,128,83,64.839996,71,12
1400000US06037197420,6037197420,2020,848,744,87.739998,660,84
1400000US06037199002,6037199002,2020,296,285,96.279999,276,9
1400000US06037199120,6037199120,2020,339,296,87.32,254,42
1400000US06037199201,6037199201,2020,315,307,97.459999,221,86
1400000US06037199202,6037199202,2020,1270,1222,96.220001,1146,76
1400000US06037199300,6037199300,2020,639,591,92.489998,491,100
1400000US06037199400,6037199400,2020,110,102,92.730003,101,1
1400000US06037199700,6037199700,2020,1504,1385,92.089996,1283,102
1400000US06037199801,6037199801,2020,373,356,95.440002,329,27
1400000US06037199802,6037199802,2020,570,532,93.330002,502,30
1400000US06037201120,6037201120,2020,187,159,85.029999,144,15
1400000US06037201200,6037201200,2020,303,275,90.760002,251,24
1400000US06037201301,6037201301,2020,289,271,93.769997,255,16
1400000US06037201302,6037201302,2020,99,65,65.660004,56,9
1400000US06037201401,6037201401,2020,1780,1579,88.709999,1459,120
1400000US06037201402,6037201402,2020,1745,1565,89.68,1464,101
1400000US06037201501,6037201501,2020,240,211,87.919998,207,4
1400000US06037201602,6037201602,2020,348,310,89.080002,286,24
1400000US06037201700,6037201700,2020,521,96,18.43,82,14
1400000US06037203100,6037203100,2020,354,334,94.349998,323,11
1400000US06037203200,6037203200,2020,648,617,95.220001,594,23
1400000US06037203300,6037203300,2020,2046,1725,84.309998,1558,167
1400000US06037203500,6037203500,2020,182,180,98.900002,169,11
1400000US06037203601,6037203601,2020,652,618,94.790001,602,16
1400000US06037203800,6037203800,2020,520,473,90.959999,460,13
1400000US06037204110,6037204110,2020,541,458,84.660004,383,75
1400000US06037204300,6037204300,2020,2380,2265,95.169998,2183,82
1400000US06037204410,6037204410,2020,253,235,92.889999,224,11
1400000US06037204420,6037204420,2020,785,734,93.5,719,15
1400000US06037204700,6037204700,2020,2405,2282,94.889999,2113,169
1400000US06037204810,6037204810,2020,1509,1385,91.779999,1330,55
1400000US06037204820,6037204820,2020,598,551,92.139999,494,57
1400000US06037204910,6037204910,2020,1284,1192,92.830002,1143,49
1400000US06037205110,6037205110,2020,1070,1001,93.550003,910,91
1400000US06037205120,6037205120,2020,84,81,96.43,79,2
1400000US06037206010,6037206010,2020,318,231,72.639999,202,29
1400000US06037206050,6037206050,2020,143,122,85.309998,97,25
1400000US06037206051,6037206051,2020,404,372,92.080002,340,32
1400000US06037206054,6037206054,2020,1410,1312,93.050003,1234,78
1400000US06037207101,6037207101,2020,1144,795,69.489998,688,107
1400000US06037207103,6037207103,2020,632,509,80.540001,465,44
1400000US06037207400,6037207400,2020,357,295,82.629997,276,19
1400000US06037207502,6037207502,2020,265,220,83.019997,204,16
1400000US06037208001,6037208001,2020,2766,2471,89.330002,2300,171
1400000US06037208002,6037208002,2020,528,494,93.559998,457,37
1400000US06037208302,6037208302,2020,1455,1343,92.300003,1299,44
1400000US06037208401,6037208401,2020,1026,1006,98.050003,989,17
1400000US06037208501,6037208501,2020,987,506,51.27,441,65
1400000US06037208610,6037208610,2020,470,452,96.169998,423,29
1400000US06037208710,6037208710,2020,60,57,95,56,1
1400000US06037208720,6037208720,2020,423,376,88.889999,305,71
1400000US06037208801,6037208801,2020,495,490,98.989998,483,7
1400000US06037208802,6037208802,2020,533,505,94.75,482,23
1400000US06037208902,6037208902,2020,1304,1301,99.769997,1289,12
1400000US06037209103,6037209103,2020,764,739,96.730003,725,14
1400000US06037209104,6037209104,2020,420,418,99.519997,415,3
1400000US06037209106,6037209106,2020,973,966,99.279999,952,14
1400000US06037209202,6037209202,2020,1132,1115,98.5,1086,29
1400000US06037209520,6037209520,2020,533,475,89.120003,432,43
1400000US06037209820,6037209820,2020,459,437,95.209999,393,44
1400000US06037210010,6037210010,2020,655,642,98.019997,619,23
1400000US06037211000,6037211000,2020,1700,1415,83.239998,1257,158
1400000US06037211121,6037211121,2020,1000,950,95,890,60
1400000US06037211122,6037211122,2020,2286,2160,94.489998,2023,137
1400000US06037211123,6037211123,2020,871,851,97.699997,811,40
1400000US06037211124,6037211124,2020,697,643,92.25,598,45
1400000US06037211202,6037211202,2020,611,597,97.709999,574,23
1400000US06037211410,6037211410,2020,601,587,97.669998,556,31
1400000US06037211420,6037211420,2020,414,346,83.57,320,26
1400000US06037212202,6037212202,2020,672,659,98.07,639,20
1400000US06037212204,6037212204,2020,824,777,94.300003,690,87
1400000US06037212303,6037212303,2020,241,231,95.849998,210,21
1400000US06037212304,6037212304,2020,3732,3519,94.290001,3364,155
1400000US06037212610,6037212610,2020,803,710,88.419998,650,60
1400000US06037212800,6037212800,2020,2045,1566,76.580002,1452,114
1400000US06037213201,6037213201,2020,588,557,94.730003,536,21
1400000US06037213202,6037213202,2020,625,607,97.120003,589,18
1400000US06037213310,6037213310,2020,113,105,92.919998,98,7
1400000US06037213320,6037213320,2020,1124,1069,95.110001,1023,46
1400000US06037213402,6037213402,2020,683,661,96.779999,640,21
1400000US06037214100,6037214100,2020,587,163,27.77,143,20
1400000US06037214501,6037214501,2020,644,179,27.799999,150,29
1400000US06037216201,6037216201,2020,108,100,92.589996,97,3
1400000US06037216301,6037216301,2020,313,201,64.220001,168,33
1400000US06037216700,6037216700,2020,1981,1110,56.029999,911,199
1400000US06037217101,6037217101,2020,280,258,92.139999,240,18
1400000US06037218110,6037218110,2020,1954,1416,72.470001,1315,101
1400000US06037218210,6037218210,2020,387,377,97.419998,356,21
1400000US06037218300,6037218300,2020,319,293,91.849998,269,24
1400000US06037218800,6037218800,2020,517,492,95.160004,471,21
1400000US06037218900,6037218900,2020,744,655,88.040001,590,65
1400000US06037219010,6037219010,2020,429,373,86.949997,360,13
1400000US06037219300,6037219300,2020,603,566,93.860001,524,42
1400000US06037219700,6037219700,2020,792,606,76.519997,591,15
1400000US06037219800,6037219800,2020,603,561,93.029999,524,37
1400000US06037219902,6037219902,2020,694,644,92.800003,613,31
1400000US06037220000,6037220000,2020,253,234,92.489998,227,7
1400000US06037220100,6037220100,2020,979,640,65.370003,606,34
1400000US06037221120,6037221120,2020,774,771,99.610001,748,23
1400000US06037221304,6037221304,2020,607,562,92.589996,538,24
1400000US06037221401,6037221401,2020,1013,937,92.5,901,36
1400000US06037221602,6037221602,2020,2033,1988,97.790001,1933,55
1400000US06037221810,6037221810,2020,487,457,93.839996,444,13
1400000US06037221900,6037221900,2020,347,336,96.830002,321,15
1400000US06037222002,6037222002,2020,496,440,88.709999,425,15
1400000US06037222500,6037222500,2020,1859,1616,86.93,1524,92
1400000US06037222600,6037222600,2020,696,593,85.199997,569,24
1400000US06037224010,6037224010,2020,27,27,100,27,0
1400000US06037224020,6037224020,2020,1833,1678,91.540001,1598,80
1400000US06037224320,6037224320,2020,465,422,90.75,395,27
1400000US06037224410,6037224410,2020,1805,1720,95.290001,1656,64
1400000US06037224420,6037224420,2020,899,769,85.540001,723,46
1400000US06037224600,6037224600,2020,1252,1173,93.690002,1140,33
1400000US06037224702,6037224702,2020,1016,902,88.779999,816,86
1400000US06037226001,6037226001,2020,2867,2789,97.279999,2690,99
1400000US06037226002,6037226002,2020,1052,996,94.68,954,42
1400000US06037226702,6037226702,2020,1218,1189,97.620003,1154,35
1400000US06037227020,6037227020,2020,1269,1231,97.010002,1202,29
1400000US06037228100,6037228100,2020,1701,1651,97.059998,1545,106
1400000US06037228210,6037228210,2020,1641,1605,97.809998,1539,66
1400000US06037228310,6037228310,2020,1332,1267,95.120003,1232,35
1400000US06037228320,6037228320,2020,591,538,91.029999,520,18
1400000US06037228410,6037228410,2020,657,617,93.910004,583,34
1400000US06037228420,6037228420,2020,1218,963,79.059998,921,42
1400000US06037228500,6037228500,2020,563,490,87.029999,477,13
1400000US06037228600,6037228600,2020,1238,1207,97.5,1175,32
1400000US06037228710,6037228710,2020,1064,1026,96.43,987,39
1400000US06037228720,6037228720,2020,786,770,97.959999,751,19
1400000US06037228800,6037228800,2020,205,204,99.510002,201,3
1400000US06037229200,6037229200,2020,645,632,97.980003,624,8
1400000US06037229300,6037229300,2020,455,361,79.339996,355,6
1400000US06037229410,6037229410,2020,2889,2820,97.610001,2727,93
1400000US06037229420,6037229420,2020,1577,1524,96.639999,1479,45
1400000US06037231100,6037231100,2020,1841,1713,93.050003,1633,80
1400000US06037231220,6037231220,2020,1131,941,83.199997,851,90
1400000US06037231302,6037231302,2020,376,341,90.690002,334,7
1400000US06037231400,6037231400,2020,111,95,85.589996,88,7
1400000US06037231500,6037231500,2020,397,369,92.949997,337,32
1400000US06037231603,6037231603,2020,1202,1003,83.440002,989,14
1400000US06037231710,6037231710,2020,446,430,96.410004,422,8
1400000US06037231720,6037231720,2020,239,221,92.470001,201,20
1400000US06037231800,6037231800,2020,652,647,99.230003,636,11
1400000US06037232110,6037232110,2020,1214,1192,98.190002,1165,27
1400000US06037232200,6037232200,2020,1416,1326,93.639999,1257,69
1400000US06037232300,6037232300,2020,242,239,98.760002,223,16
1400000US06037232401,6037232401,2020,732,617,84.290001,605,12
1400000US06037232402,6037232402,2020,230,210,91.300003,198,12
1400000US06037232500,6037232500,2020,491,455,92.669998,441,14
1400000US06037234001,6037234001,2020,724,664,91.709999,623,41
1400000US06037234002,6037234002,2020,423,409,96.690002,357,52
1400000US06037234301,6037234301,2020,606,556,91.75,542,14
1400000US06037234501,6037234501,2020,967,856,88.519997,843,13
1400000US06037234502,6037234502,2020,677,577,85.230003,549,28
1400000US06037234600,6037234600,2020,2217,1957,88.269997,1807,150
1400000US06037234700,6037234700,2020,239,213,89.120003,198,15
1400000US06037234901,6037234901,2020,471,415,88.110001,411,4
1400000US06037234902,6037234902,2020,185,160,86.489998,154,6
1400000US06037235201,6037235201,2020,1046,975,93.209999,921,54
1400000US06037236203,6037236203,2020,666,626,93.989998,569,57
1400000US06037236204,6037236204,2020,554,543,98.010002,531,12
1400000US06037236400,6037236400,2020,181,174,96.129997,170,4
1400000US06037237101,6037237101,2020,2656,2313,87.089996,2261,52
1400000US06037237102,6037237102,2020,609,575,94.419998,563,12
1400000US06037237300,6037237300,2020,492,398,80.889999,394,4
1400000US06037237500,6037237500,2020,545,521,95.599998,498,23
1400000US06037237600,6037237600,2020,666,648,97.300003,632,16
1400000US06037237800,6037237800,2020,497,443,89.129997,430,13
1400000US06037237900,6037237900,2020,396,344,86.870003,327,17
1400000US06037238000,6037238000,2020,734,713,97.139999,703,10
1400000US06037238100,6037238100,2020,134,130,97.010002,127,3
1400000US06037238200,6037238200,2020,602,549,91.199997,531,18
1400000US06037238320,6037238320,2020,1206,1084,89.879997,1004,80
1400000US06037238400,6037238400,2020,353,335,94.900002,330,5
1400000US06037239201,6037239201,2020,1100,1096,99.639999,1084,12
1400000US06037239320,6037239320,2020,976,954,97.75,943,11
1400000US06037239330,6037239330,2020,793,765,96.470001,748,17
1400000US06037239502,6037239502,2020,3537,3432,97.029999,3347,85
1400000US06037239601,6037239601,2020,969,889,91.739998,875,14
1400000US06037239802,6037239802,2020,920,884,96.089996,854,30
1400000US06037240010,6037240010,2020,1034,1000,96.709999,965,35
1400000US06037240020,6037240020,2020,454,412,90.75,381,31
1400000US06037240200,6037240200,2020,725,705,97.239998,684,21
1400000US06037240301,6037240301,2020,772,737,95.470001,721,16
1400000US06037240302,6037240302,2020,153,144,94.120003,141,3
1400000US06037240401,6037240401,2020,1094,1068,97.620003,1030,38
1400000US06037240500,6037240500,2020,1432,1408,98.32,1338,70
1400000US06037240600,6037240600,2020,964,947,98.239998,923,24
1400000US06037240700,6037240700,2020,541,519,95.93,506,13
1400000US06037240902,6037240902,2020,2119,2054,96.93,1962,92
1400000US06037241001,6037241001,2020,879,865,98.410004,826,39
1400000US06037241110,6037241110,2020,962,946,98.339996,923,23
1400000US06037241120,6037241120,2020,452,452,100,447,5
1400000US06037241202,6037241202,2020,581,567,97.589996,541,26
1400000US06037241400,6037241400,2020,562,553,98.400002,535,18
1400000US06037242000,6037242000,2020,334,332,99.400002,319,13
1400000US06037242100,6037242100,2020,861,832,96.629997,794,38
1400000US06037242201,6037242201,2020,778,750,96.400002,733,17
1400000US06037242202,6037242202,2020,720,695,96.529999,664,31
1400000US06037242300,6037242300,2020,662,646,97.580002,623,23
1400000US06037242600,6037242600,2020,633,631,99.68,625,6
1400000US06037242700,6037242700,2020,1254,1219,97.209999,1199,20
1400000US06037243001,6037243001,2020,492,421,85.57,410,11
1400000US06037243002,6037243002,2020,382,377,98.690002,368,9
1400000US06037243100,6037243100,2020,438,430,98.169998,421,9
1400000US06037262200,6037262200,2020,903,158,17.5,139,19
1400000US06037262303,6037262303,2020,548,34,6.1999998,32,2
1400000US06037262604,6037262604,2020,482,62,12.86,62,0
1400000US06037262704,6037262704,2020,2964,882,29.76,744,138
1400000US06037262706,6037262706,2020,492,40,8.1300001,33,7
1400000US06037262802,6037262802,2020,2450,510,20.82,462,48
1400000US06037264305,6037264305,2020,393,333,84.730003,312,21
1400000US06037265100,6037265100,2020,701,47,6.6999998,40,7
1400000US06037265601,6037265601,2020,1000,376,37.599998,312,64
1400000US06037267202,6037267202,2020,804,90,11.19,75,15
1400000US06037267300,6037267300,2020,250,193,77.199997,171,22
1400000US06037267404,6037267404,2020,1463,1041,71.160004,865,176
1400000US06037267406,6037267406,2020,198,151,76.260002,134,17
1400000US06037267600,6037267600,2020,992,282,28.43,242,40
1400000US06037269000,6037269000,2020,557,166,29.799999,136,30
1400000US06037269100,6037269100,2020,392,114,29.08,101,13
1400000US06037269300,6037269300,2020,475,36,7.5799999,35,1
1400000US06037269700,6037269700,2020,2977,2099,70.510002,1825,274
1400000US06037269907,6037269907,2020,298,228,76.510002,212,16
1400000US06037271200,6037271200,2020,637,235,36.889999,204,31
1400000US06037271300,6037271300,2020,900,579,64.330002,542,37
1400000US06037271400,6037271400,2020,272,103,37.869999,95,8
1400000US06037271500,6037271500,2020,583,68,11.66,61,7
1400000US06037271702,6037271702,2020,528,139,26.33,120,19
1400000US06037271703,6037271703,2020,1317,766,58.16,661,105
1400000US06037271801,6037271801,2020,297,214,72.050003,201,13
1400000US06037272100,6037272100,2020,1183,694,58.66,613,81
1400000US06037272302,6037272302,2020,18,14,77.779999,13,1
1400000US06037273200,6037273200,2020,1141,585,51.27,487,98
1400000US06037273403,6037273403,2020,404,312,77.230003,282,30
1400000US06037273800,6037273800,2020,2548,1487,58.360001,1300,187
1400000US06037274202,6037274202,2020,376,295,78.459999,274,21
1400000US06037275200,6037275200,2020,524,514,98.089996,445,69
1400000US06037275311,6037275311,2020,1448,687,47.439999,618,69
1400000US06037275400,6037275400,2020,317,170,53.630001,148,22
1400000US06037275500,6037275500,2020,793,562,70.870003,503,59
1400000US06037275603,6037275603,2020,261,103,39.459999,83,20
1400000US06037275604,6037275604,2020,571,84,14.71,70,14
1400000US06037275605,6037275605,2020,401,327,81.550003,267,60
1400000US06037276000,6037276000,2020,216,134,62.040001,104,30
1400000US06037276400,6037276400,2020,336,89,26.49,75,14
1400000US06037276605,6037276605,2020,324,217,66.980003,186,31
1400000US06037276607,6037276607,2020,340,227,66.760002,202,25
1400000US06037276608,6037276608,2020,1170,766,65.470001,651,115
1400000US06037277000,6037277000,2020,1729,813,47.02,722,91
1400000US06037277100,6037277100,2020,402,66,16.42,48,18
1400000US06037291120,6037291120,2020,660,606,91.82,571,35
1400000US06037291210,6037291210,2020,499,445,89.18,420,25
1400000US06037291220,6037291220,2020,349,296,84.809998,277,19
1400000US06037291300,6037291300,2020,949,758,79.870003,651,107
1400000US06037293204,6037293204,2020,476,412,86.550003,384,28
1400000US06037293302,6037293302,2020,2892,2264,78.279999,1951,313
1400000US06037293304,6037293304,2020,497,452,90.949997,429,23
1400000US06037294110,6037294110,2020,3105,2763,88.989998,2520,243
1400000US06037294200,6037294200,2020,1723,1564,90.769997,1479,85
1400000US06037294302,6037294302,2020,469,301,64.18,204,97
1400000US06037294410,6037294410,2020,275,265,96.360001,257,8
1400000US06037294510,6037294510,2020,732,677,92.489998,624,53
1400000US06037294520,6037294520,2020,415,401,96.629997,371,30
1400000US06037294610,6037294610,2020,1201,1070,89.089996,996,74
1400000US06037294620,6037294620,2020,629,597,94.910004,552,45
1400000US06037294830,6037294830,2020,587,564,96.080002,534,30
1400000US06037294900,6037294900,2020,599,578,96.489998,554,24
1400000US06037295103,6037295103,2020,845,483,57.16,372,111
1400000US06037296220,6037296220,2020,937,530,56.560001,449,81
1400000US06037296300,6037296300,2020,641,378,58.970001,291,87
1400000US06037296401,6037296401,2020,336,227,67.559998,193,34
1400000US06037296500,6037296500,2020,755,685,90.730003,656,29
1400000US06037296600,6037296600,2020,373,351,94.099998,332,19
1400000US06037296901,6037296901,2020,4053,2698,66.57,2350,348
1400000US06037297110,6037297110,2020,235,190,80.849998,172,18
1400000US06037297120,6037297120,2020,460,419,91.089996,396,23
1400000US06037297202,6037297202,2020,453,382,84.330002,325,57
1400000US06037297400,6037297400,2020,467,223,47.75,181,42
1400000US06037297501,6037297501,2020,346,137,39.599998,90,47
1400000US06037297601,6037297601,2020,62,55,88.709999,52,3
1400000US06037297602,6037297602,2020,329,220,66.870003,168,52
1400000US06037300200,6037300200,2020,2545,460,18.07,372,88
1400000US06037300301,6037300301,2020,2303,830,36.040001,665,165
1400000US06037300400,6037300400,2020,494,119,24.09,95,24
1400000US06037300501,6037300501,2020,3076,722,23.469999,573,149
1400000US06037300602,6037300602,2020,660,140,21.209999,111,29
1400000US06037300800,6037300800,2020,726,217,29.889999,176,41
1400000US06037300902,6037300902,2020,516,184,35.66,159,25
1400000US06037301000,6037301000,2020,1237,747,60.389999,626,121
1400000US06037301206,6037301206,2020,3741,2072,55.389999,1661,411
1400000US06037301400,6037301400,2020,837,504,60.220001,436,68
1400000US06037301502,6037301502,2020,651,498,76.5,416,82
1400000US06037301602,6037301602,2020,608,92,15.13,71,21
1400000US06037301801,6037301801,2020,489,378,77.300003,319,59
1400000US06037301902,6037301902,2020,958,607,63.360001,502,105
1400000US06037302002,6037302002,2020,139,105,75.540001,87,18
1400000US06037302004,6037302004,2020,473,388,82.029999,338,50
1400000US06037302104,6037302104,2020,2074,1422,68.559998,1194,228
1400000US06037302302,6037302302,2020,885,500,56.5,408,92
1400000US06037302504,6037302504,2020,2191,1761,80.370003,1486,275
1400000US06037302505,6037302505,2020,422,347,82.230003,286,61
1400000US06037310201,6037310201,2020,616,216,35.060001,189,27
1400000US06037310300,6037310300,2020,2207,719,32.580002,616,103
1400000US06037310601,6037310601,2020,450,252,56,221,31
1400000US06037310602,6037310602,2020,2493,944,37.869999,832,112
1400000US06037310703,6037310703,2020,750,339,45.200001,306,33
1400000US06037310705,6037310705,2020,19,18,94.739998,16,2
1400000US06037310800,6037310800,2020,2864,918,32.049999,751,167
1400000US06037310900,6037310900,2020,686,197,28.719999,178,19
1400000US06037311000,6037311000,2020,970,364,37.529999,291,73
1400000US06037311100,6037311100,2020,946,365,38.580002,284,81
1400000US06037311200,6037311200,2020,83,15,18.07,14,1
1400000US06037311500,6037311500,2020,1227,191,15.57,160,31
1400000US06037311700,6037311700,2020,1107,353,31.889999,281,72
1400000US06037311802,6037311802,2020,479,189,39.459999,157,32
1400000US06037320101,6037320101,2020,477,377,79.040001,347,30
1400000US06037320102,6037320102,2020,1663,1453,87.370003,1348,105
1400000US06037320201,6037320201,2020,1409,1307,92.760002,1218,89
1400000US06037320202,6037320202,2020,479,436,91.019997,401,35
1400000US06037320300,6037320300,2020,1968,1835,93.239998,1671,164
1400000US06037400205,6037400205,2020,65,65,100,65,0
1400000US06037400208,6037400208,2020,577,92,15.94,81,11
1400000US06037400304,6037400304,2020,965,504,52.23,449,55
1400000US06037400402,6037400402,2020,2268,580,25.57,491,89
1400000US06037400403,6037400403,2020,50,50,100,50,0
1400000US06037400404,6037400404,2020,604,97,16.059999,82,15
1400000US06037400501,6037400501,2020,882,166,18.82,141,25
1400000US06037400602,6037400602,2020,564,410,72.699997,345,65
1400000US06037400605,6037400605,2020,282,231,81.910004,203,28
1400000US06037400801,6037400801,2020,2066,831,40.220001,700,131
1400000US06037401001,6037401001,2020,589,137,23.26,119,18
1400000US06037401202,6037401202,2020,872,387,44.380001,317,70
1400000US06037401203,6037401203,2020,127,65,51.18,61,4
1400000US06037401311,6037401311,2020,1132,297,26.24,247,50
1400000US06037401312,6037401312,2020,2249,900,40.02,760,140
1400000US06037401601,6037401601,2020,494,137,27.73,119,18
1400000US06037401602,6037401602,2020,2575,928,36.040001,784,144
1400000US06037401705,6037401705,2020,492,204,41.459999,187,17
1400000US06037401707,6037401707,2020,362,339,93.650002,305,34
1400000US06037401801,6037401801,2020,656,131,19.969999,105,26
1400000US06037401802,6037401802,2020,2976,855,28.73,721,134
1400000US06037401902,6037401902,2020,1949,689,35.349998,568,121
1400000US06037402001,6037402001,2020,349,240,68.769997,194,46
1400000US06037402002,6037402002,2020,324,157,48.459999,134,23
1400000US06037402101,6037402101,2020,320,303,94.690002,281,22
1400000US06037402102,6037402102,2020,2050,1861,90.779999,1597,264
1400000US06037402200,6037402200,2020,314,271,86.309998,223,48
1400000US06037402301,6037402301,2020,1199,1073,89.489998,938,135
1400000US06037402303,6037402303,2020,352,323,91.760002,298,25
1400000US06037402403,6037402403,2020,777,451,58.040001,375,76
1400000US06037402405,6037402405,2020,897,844,94.089996,728,116
1400000US06037402406,6037402406,2020,1006,956,95.029999,870,86
1400000US06037402501,6037402501,2020,1192,1143,95.889999,1066,77
1400000US06037402503,6037402503,2020,850,799,94,721,78
1400000US06037402504,6037402504,2020,463,441,95.25,413,28
1400000US06037402601,6037402601,2020,663,624,94.120003,568,56
1400000US06037402702,6037402702,2020,1080,1016,94.07,907,109
1400000US06037402703,6037402703,2020,275,229,83.269997,190,39
1400000US06037402705,6037402705,2020,545,508,93.209999,476,32
1400000US06037402706,6037402706,2020,253,244,96.440002,218,26
1400000US06037402902,6037402902,2020,606,572,94.389999,481,91
1400000US06037402903,6037402903,2020,1549,1463,94.449997,1309,154
1400000US06037403000,6037403000,2020,2963,2793,94.260002,2492,301
1400000US06037403316,6037403316,2020,937,656,70.010002,484,172
1400000US06037403317,6037403317,2020,1899,1263,66.510002,908,355
1400000US06037403318,6037403318,2020,502,370,73.709999,281,89
1400000US06037403320,6037403320,2020,409,226,55.259998,170,56
1400000US06037403321,6037403321,2020,280,204,72.860001,157,47
1400000US06037403323,6037403323,2020,1740,364,20.92,338,26
1400000US06037403324,6037403324,2020,646,140,21.67,128,12
1400000US06037403325,6037403325,2020,3855,706,18.309999,660,46
1400000US06037403326,6037403326,2020,665,147,22.110001,137,10
1400000US06037403327,6037403327,2020,298,191,64.089996,150,41
1400000US06037403401,6037403401,2020,472,124,26.27,116,8
1400000US06037403402,6037403402,2020,2831,627,22.15,562,65
1400000US06037403404,6037403404,2020,1244,278,22.35,248,30
1400000US06037403407,6037403407,2020,605,93,15.37,87,6
1400000US06037403408,6037403408,2020,1001,533,53.25,400,133
1400000US06037403409,6037403409,2020,573,133,23.209999,120,13
1400000US06037403601,6037403601,2020,843,531,62.990002,431,100
1400000US06037403702,6037403702,2020,1841,998,54.209999,876,122
1400000US06037403703,6037403703,2020,374,249,66.580002,224,25
1400000US06037403722,6037403722,2020,677,402,59.380001,348,54
1400000US06037403801,6037403801,2020,1099,748,68.059998,672,76
1400000US06037403901,6037403901,2020,50,24,48,22,2
1400000US06037403902,6037403902,2020,417,234,56.119999,207,27
1400000US06037404000,6037404000,2020,515,464,90.099998,408,56
1400000US06037404100,6037404100,2020,449,414,92.199997,381,33
1400000US06037404201,6037404201,2020,1885,1599,84.830002,1403,196
1400000US06037404203,6037404203,2020,257,193,75.099998,179,14
1400000US06037404401,6037404401,2020,636,536,84.279999,456,80
1400000US06037404402,6037404402,2020,529,446,84.309998,390,56
1400000US06037404503,6037404503,2020,414,376,90.82,340,36
1400000US06037404504,6037404504,2020,434,417,96.080002,397,20
1400000US06037404600,6037404600,2020,2755,2094,76.010002,1863,231
1400000US06037404701,6037404701,2020,777,669,86.099998,664,5
1400000US06037404702,6037404702,2020,682,605,88.709999,603,2
1400000US06037404804,6037404804,2020,2571,2123,82.57,2104,19
1400000US06037404805,6037404805,2020,508,448,88.190002,442,6
1400000US06037404806,6037404806,2020,958,851,88.830002,843,8
1400000US06037404901,6037404901,2020,509,434,85.269997,396,38
1400000US06037404903,6037404903,2020,456,393,86.18,386,7
1400000US06037405001,6037405001,2020,911,771,84.629997,729,42
1400000US06037405002,6037405002,2020,339,312,92.040001,310,2
1400000US06037405101,6037405101,2020,1396,1161,83.169998,1114,47
1400000US06037405201,6037405201,2020,2124,1785,84.040001,1765,20
1400000US06037405202,6037405202,2020,606,529,87.290001,467,62
1400000US06037405302,6037405302,2020,482,363,75.309998,317,46
1400000US06037405400,6037405400,2020,390,272,69.739998,237,35
1400000US06037405600,6037405600,2020,1008,718,71.230003,580,138
1400000US06037405701,6037405701,2020,805,623,77.389999,527,96
1400000US06037405702,6037405702,2020,1245,902,72.449997,746,156
1400000US06037405800,6037405800,2020,1564,1225,78.32,1079,146
1400000US06037406000,6037406000,2020,1834,1343,73.230003,1113,230
1400000US06037406103,6037406103,2020,596,397,66.610001,349,48
1400000US06037406201,6037406201,2020,1214,863,71.089996,723,140
1400000US06037406300,6037406300,2020,2364,1248,52.790001,1009,239
1400000US06037406413,6037406413,2020,1441,906,62.869999,748,158
1400000US06037406601,6037406601,2020,3419,2467,72.160004,2115,352
1400000US06037406602,6037406602,2020,342,268,78.360001,221,47
1400000US06037406701,6037406701,2020,282,235,83.330002,185,50
1400000US06037406702,6037406702,2020,208,180,86.540001,146,34
1400000US06037406801,6037406801,2020,2041,1491,73.050003,1236,255
1400000US06037406903,6037406903,2020,2250,1540,68.440002,1260,280
1400000US06037407001,6037407001,2020,363,324,89.260002,301,23
1400000US06037407002,6037407002,2020,546,513,93.959999,473,40
1400000US06037407101,6037407101,2020,1627,1462,89.860001,1332,130
1400000US06037407201,6037407201,2020,298,266,89.260002,229,37
1400000US06037407301,6037407301,2020,330,304,92.120003,272,32
1400000US06037407302,6037407302,2020,1095,982,89.68,844,138
1400000US06037407501,6037407501,2020,896,705,78.68,559,146
1400000US06037407502,6037407502,2020,618,526,85.110001,451,75
1400000US06037407602,6037407602,2020,572,509,88.989998,451,58
1400000US06037407701,6037407701,2020,501,486,97.010002,456,30
1400000US06037407702,6037407702,2020,1390,1170,84.169998,1021,149
1400000US06037407801,6037407801,2020,472,394,83.470001,345,49
1400000US06037407802,6037407802,2020,1722,1465,85.080002,1230,235
1400000US06037407901,6037407901,2020,576,471,81.769997,404,67
1400000US06037408003,6037408003,2020,136,105,77.209999,95,10
1400000US06037408135,6037408135,2020,544,482,88.599998,449,33
1400000US06037408136,6037408136,2020,381,327,85.830002,283,44
1400000US06037408137,6037408137,2020,705,593,84.110001,525,68
1400000US06037408138,6037408138,2020,386,363,94.040001,338,25
1400000US06037408139,6037408139,2020,440,429,97.5,385,44
1400000US06037408140,6037408140,2020,591,552,93.400002,507,45
1400000US06037408141,6037408141,2020,2225,1966,88.360001,1766,200
1400000US06037408212,6037408212,2020,704,425,60.369999,352,73
1400000US06037408213,6037408213,2020,368,318,86.410004,279,39
1400000US06037408301,6037408301,2020,475,442,93.050003,410,32
1400000US06037408302,6037408302,2020,628,399,63.540001,339,60
1400000US06037408401,6037408401,2020,14,9,64.290001,7,2
1400000US06037408402,6037408402,2020,890,723,81.239998,594,129
1400000US06037408503,6037408503,2020,970,514,52.990002,384,130
1400000US06037408504,6037408504,2020,584,350,59.93,278,72
1400000US06037408505,6037408505,2020,1989,1346,67.669998,1069,277
1400000US06037408623,6037408623,2020,2040,1098,53.82,843,255
1400000US06037408624,6037408624,2020,244,188,77.050003,161,27
1400000US06037408625,6037408625,2020,1703,831,48.799999,640,191
1400000US06037408631,6037408631,2020,591,428,72.419998,366,62
1400000US06037408705,6037408705,2020,2955,2003,67.779999,1629,374
1400000US06037408707,6037408707,2020,932,216,23.18,194,22
1400000US06037408722,6037408722,2020,671,418,62.299999,323,95
1400000US06037408724,6037408724,2020,511,433,84.739998,405,28
1400000US06037408725,6037408725,2020,694,539,77.669998,457,82
1400000US06037408800,6037408800,2020,2,0,0,0,0
1400000US06037408900,6037408900,2020,1819,714,39.25,568,146
1400000US06037409000,6037409000,2020,517,467,90.330002,404,63
1400000US06037409100,6037409100,2020,174,148,85.059998,134,14
1400000US06037430003,6037430003,2020,355,191,53.799999,155,36
1400000US06037430005,6037430005,2020,382,312,81.68,262,50
1400000US06037430101,6037430101,2020,1866,877,47,733,144
1400000US06037430102,6037430102,2020,436,368,84.400002,319,49
1400000US06037430200,6037430200,2020,882,387,43.880001,291,96
1400000US06037430302,6037430302,2020,535,221,41.310001,186,35
1400000US06037430400,6037430400,2020,1392,237,17.030001,203,34
1400000US06037430502,6037430502,2020,1283,356,27.75,235,121
1400000US06037430701,6037430701,2020,597,159,26.629999,137,22
1400000US06037430721,6037430721,2020,3017,772,25.59,648,124
1400000US06037430801,6037430801,2020,873,252,28.870001,210,42
1400000US06037430802,6037430802,2020,1352,403,29.809999,325,78
1400000US06037431002,6037431002,2020,553,358,64.739998,319,39
1400000US06037431003,6037431003,2020,1544,816,52.849998,682,134
1400000US06037431004,6037431004,2020,1669,1008,60.400002,826,182
1400000US06037431100,6037431100,2020,511,382,74.760002,322,60
1400000US06037431200,6037431200,2020,482,393,81.540001,363,30
1400000US06037431400,6037431400,2020,438,272,62.099998,233,39
1400000US06037431501,6037431501,2020,389,306,78.660004,250,56
1400000US06037431502,6037431502,2020,695,603,86.760002,519,84
1400000US06037431600,6037431600,2020,497,139,27.969999,114,25
1400000US06037431701,6037431701,2020,1348,384,28.49,321,63
1400000US06037431800,6037431800,2020,1933,786,40.66,633,153
1400000US06037431900,6037431900,2020,978,385,39.369999,327,58
1400000US06037432002,6037432002,2020,461,182,39.48,147,35
1400000US06037432102,6037432102,2020,573,230,40.139999,194,36
1400000US06037432201,6037432201,2020,469,349,74.410004,276,73
1400000US06037432202,6037432202,2020,2564,2119,82.639999,1717,402
1400000US06037432300,6037432300,2020,842,776,92.160004,697,79
1400000US06037432401,6037432401,2020,2637,2320,87.980003,2008,312
1400000US06037432402,6037432402,2020,493,460,93.309998,398,62
1400000US06037432501,6037432501,2020,352,327,92.900002,288,39
1400000US06037432602,6037432602,2020,1374,1260,91.699997,1128,132
1400000US06037432700,6037432700,2020,19,17,89.470001,15,2
1400000US06037432801,6037432801,2020,542,525,96.860001,501,24
1400000US06037432902,6037432902,2020,399,341,85.459999,282,59
1400000US06037433103,6037433103,2020,400,391,97.75,354,37
1400000US06037433200,6037433200,2020,2788,2646,94.910004,2378,268
1400000US06037433302,6037433302,2020,768,722,94.010002,672,50
1400000US06037433305,6037433305,2020,456,417,91.449997,395,22
1400000US06037433306,6037433306,2020,369,337,91.330002,317,20
1400000US06037433307,6037433307,2020,612,545,89.050003,507,38
1400000US06037433505,6037433505,2020,1203,1157,96.18,1062,95
1400000US06037433803,6037433803,2020,1692,1488,87.940002,1348,140
1400000US06037433804,6037433804,2020,1003,866,86.339996,800,66
1400000US06037433901,6037433901,2020,445,415,93.260002,399,16
1400000US06037433903,6037433903,2020,1129,1060,93.889999,998,62
1400000US06037434001,6037434001,2020,1230,1138,92.519997,1028,110
1400000US06037434003,6037434003,2020,1168,1091,93.410004,1024,67
1400000US06037434100,6037434100,2020,543,427,78.639999,371,56
1400000US06037460002,6037460002,2020,494,246,49.799999,189,57
1400000US06037460101,6037460101,2020,410,81,19.76,68,13
1400000US06037460200,6037460200,2020,192,129,67.190002,108,21
1400000US06037460301,6037460301,2020,469,184,39.23,165,19
1400000US06037460302,6037460302,2020,644,299,46.43,248,51
1400000US06037460501,6037460501,2020,722,28,3.8800001,28,0
1400000US06037460502,6037460502,2020,634,15,2.3699999,15,0
1400000US06037460601,6037460601,2020,670,36,5.3699999,36,0
1400000US06037460700,6037460700,2020,2035,100,4.9099998,97,3
1400000US06037460900,6037460900,2020,998,715,71.639999,620,95
1400000US06037461000,6037461000,2020,651,408,62.669998,338,70
1400000US06037461100,6037461100,2020,262,174,66.410004,145,29
1400000US06037461200,6037461200,2020,503,368,73.160004,338,30
1400000US06037461300,6037461300,2020,320,207,64.690002,164,43
1400000US06037461400,6037461400,2020,386,338,87.559998,300,38
1400000US06037461502,6037461502,2020,902,782,86.699997,724,58
1400000US06037461700,6037461700,2020,284,250,88.029999,236,14
1400000US06037462100,6037462100,2020,387,366,94.57,349,17
1400000US06037462500,6037462500,2020,2324,1642,70.650002,1321,321
1400000US06037462600,6037462600,2020,1895,1363,71.93,1042,321
1400000US06037462700,6037462700,2020,396,336,84.849998,292,44
1400000US06037462900,6037462900,2020,123,115,93.5,106,9
1400000US06037463000,6037463000,2020,485,135,27.84,77,58
1400000US06037463200,6037463200,2020,969,720,74.300003,600,120
1400000US06037463300,6037463300,2020,551,281,51,203,78
1400000US06037463601,6037463601,2020,1095,796,72.690002,694,102
1400000US06037463800,6037463800,2020,407,143,35.139999,124,19
1400000US06037464000,6037464000,2020,982,620,63.139999,522,98
1400000US06037464101,6037464101,2020,1240,89,7.1799998,76,13
1400000US06037464200,6037464200,2020,1011,80,7.9099998,72,8
1400000US06037480002,6037480002,2020,881,140,15.89,117,23
1400000US06037480012,6037480012,2020,1581,587,37.130001,469,118
1400000US06037480201,6037480201,2020,329,130,39.509998,108,22
1400000US06037480202,6037480202,2020,444,222,50,177,45
1400000US06037480302,6037480302,2020,420,313,74.519997,276,37
1400000US06037480304,6037480304,2020,2761,1935,70.080002,1550,385
1400000US06037480400,6037480400,2020,1573,920,58.490002,717,203
1400000US06037480500,6037480500,2020,1977,304,15.38,251,53
1400000US06037480702,6037480702,2020,676,101,14.94,92,9
1400000US06037480703,6037480703,2020,718,100,13.93,84,16
1400000US06037480704,6037480704,2020,1397,272,19.469999,234,38
1400000US06037480803,6037480803,2020,438,287,65.529999,235,52
1400000US06037480804,6037480804,2020,705,442,62.700001,351,91
1400000US06037480901,6037480901,2020,171,112,65.5,109,3
1400000US06037480903,6037480903,2020,836,515,61.599998,422,93
1400000US06037481101,6037481101,2020,494,343,69.43,298,45
1400000US06037481102,6037481102,2020,39,27,69.230003,27,0
1400000US06037481103,6037481103,2020,1961,1535,78.279999,1325,210
1400000US06037481203,6037481203,2020,1508,940,62.330002,802,138
1400000US06037481300,6037481300,2020,589,455,77.25,347,108
1400000US06037481401,6037481401,2020,587,413,70.360001,339,74
1400000US06037481403,6037481403,2020,392,337,85.970001,296,41
1400000US06037481404,6037481404,2020,1644,893,54.32,733,160
1400000US06037481500,6037481500,2020,2234,1300,58.189999,1047,253
1400000US06037481606,6037481606,2020,825,593,71.879997,496,97
1400000US06037481901,6037481901,2020,566,328,57.950001,259,69
1400000US06037482001,6037482001,2020,991,449,45.310001,354,95
1400000US06037482002,6037482002,2020,897,344,38.349998,278,66
1400000US06037482101,6037482101,2020,778,568,73.010002,489,79
1400000US06037482102,6037482102,2020,782,409,52.299999,319,90
1400000US06037482202,6037482202,2020,555,388,69.910004,340,48
1400000US06037482303,6037482303,2020,88,79,89.769997,73,6
1400000US06037482304,6037482304,2020,454,386,85.019997,350,36
1400000US06037482401,6037482401,2020,332,271,81.629997,247,24
1400000US06037482403,6037482403,2020,1092,958,87.730003,875,83
1400000US06037482502,6037482502,2020,1106,940,84.989998,860,80
1400000US06037482522,6037482522,2020,386,239,61.919998,189,50
1400000US06037482600,6037482600,2020,399,278,69.669998,234,44
1400000US06037482701,6037482701,2020,513,398,77.580002,343,55
1400000US06037482801,6037482801,2020,705,546,77.449997,455,91
1400000US06037500202,6037500202,2020,3737,1971,52.740002,1483,488
1400000US06037500203,6037500203,2020,555,128,23.059999,97,31
1400000US06037500300,6037500300,2020,431,287,66.589996,243,44
1400000US06037500402,6037500402,2020,652,507,77.760002,447,60
1400000US06037500404,6037500404,2020,365,309,84.660004,261,48
1400000US06037500600,6037500600,2020,686,572,83.379997,504,68
1400000US06037500700,6037500700,2020,461,320,69.410004,267,53
1400000US06037500800,6037500800,2020,2706,1816,67.110001,1535,281
1400000US06037500900,6037500900,2020,504,405,80.360001,366,39
1400000US06037501001,6037501001,2020,336,283,84.230003,242,41
1400000US06037501002,6037501002,2020,1357,1113,82.019997,972,141
1400000US06037501200,6037501200,2020,363,274,75.480003,231,43
1400000US06037501302,6037501302,2020,1407,1110,78.889999,975,135
1400000US06037501400,6037501400,2020,1809,1357,75.010002,1114,243
1400000US06037501600,6037501600,2020,410,301,73.410004,260,41
1400000US06037501700,6037501700,2020,699,287,41.060001,232,55
1400000US06037501804,6037501804,2020,396,353,89.139999,319,34
1400000US06037502003,6037502003,2020,397,339,85.389999,286,53
1400000US06037502005,6037502005,2020,561,420,74.870003,361,59
1400000US06037502200,6037502200,2020,564,404,71.629997,344,60
1400000US06037502303,6037502303,2020,2301,1860,80.830002,1632,228
1400000US06037502401,6037502401,2020,1256,933,74.279999,780,153
1400000US06037502500,6037502500,2020,268,195,72.760002,166,29
1400000US06037502602,6037502602,2020,394,307,77.919998,264,43
1400000US06037502603,6037502603,2020,602,395,65.610001,321,74
1400000US06037502604,6037502604,2020,375,295,78.669998,250,45
1400000US06037502700,6037502700,2020,753,515,68.389999,414,101
1400000US06037502801,6037502801,2020,3450,2400,69.57,1691,709
1400000US06037503103,6037503103,2020,444,407,91.669998,367,40
1400000US06037503105,6037503105,2020,549,485,88.339996,419,66
1400000US06037503201,6037503201,2020,390,277,71.029999,230,47
1400000US06037503202,6037503202,2020,353,301,85.269997,265,36
1400000US06037503302,6037503302,2020,3313,2397,72.349998,1962,435
1400000US06037503402,6037503402,2020,588,183,31.120001,139,44
1400000US06037503501,6037503501,2020,1038,652,62.810001,531,121
1400000US06037503502,6037503502,2020,686,487,70.989998,409,78
1400000US06037503602,6037503602,2020,2445,1350,55.209999,1225,125
1400000US06037503701,6037503701,2020,1712,788,46.029999,640,148
1400000US06037503705,6037503705,2020,266,141,53.009998,135,6
1400000US06037503801,6037503801,2020,1032,576,55.810001,542,34
1400000US06037503802,6037503802,2020,378,197,52.119999,176,21
1400000US06037503902,6037503902,2020,527,244,46.299999,213,31
1400000US06037504002,6037504002,2020,1409,744,52.799999,691,53
1400000US06037504101,6037504101,2020,312,264,84.620003,247,17
1400000US06037504200,6037504200,2020,1721,1481,86.050003,1280,201
1400000US06037530005,6037530005,2020,2626,2080,79.209999,1758,322
1400000US06037530007,6037530007,2020,1822,1465,80.410004,1309,156
1400000US06037530101,6037530101,2020,313,269,85.940002,247,22
1400000US06037530102,6037530102,2020,4062,3550,87.400002,3154,396
1400000US06037530202,6037530202,2020,685,649,94.739998,610,39
1400000US06037530203,6037530203,2020,522,442,84.669998,405,37
1400000US06037530301,6037530301,2020,3468,3279,94.550003,3072,207
1400000US06037530400,6037530400,2020,1853,1626,87.75,1352,274
1400000US06037530500,6037530500,2020,659,598,90.739998,556,42
1400000US06037530603,6037530603,2020,630,525,83.330002,467,58
1400000US06037530700,6037530700,2020,576,506,87.849998,456,50
1400000US06037530801,6037530801,2020,358,337,94.129997,327,10
1400000US06037530902,6037530902,2020,559,541,96.779999,515,26
1400000US06037531000,6037531000,2020,3000,2818,93.93,2624,194
1400000US06037531101,6037531101,2020,2990,2552,85.349998,2415,137
1400000US06037531102,6037531102,2020,906,869,95.919998,841,28
1400000US06037531201,6037531201,2020,712,682,95.790001,652,30
1400000US06037531202,6037531202,2020,145,133,91.720001,124,9
1400000US06037531302,6037531302,2020,1170,1079,92.220001,1003,76
1400000US06037531502,6037531502,2020,904,818,90.489998,768,50
1400000US06037531503,6037531503,2020,537,523,97.389999,491,32
1400000US06037531603,6037531603,2020,1410,1312,93.050003,1236,76
1400000US06037531604,6037531604,2020,170,167,98.239998,163,4
1400000US06037531701,6037531701,2020,579,483,83.419998,420,63
1400000US06037531702,6037531702,2020,544,462,84.93,447,15
1400000US06037531800,6037531800,2020,653,552,84.529999,520,32
1400000US06037531902,6037531902,2020,482,429,89,392,37
1400000US06037532002,6037532002,2020,512,433,84.57,392,41
1400000US06037532101,6037532101,2020,40,26,65,25,1
1400000US06037532102,6037532102,2020,830,740,89.160004,703,37
1400000US06037532200,6037532200,2020,224,167,74.550003,159,8
1400000US06037532302,6037532302,2020,390,324,83.080002,303,21
1400000US06037532303,6037532303,2020,755,521,69.010002,453,68
1400000US06037532500,6037532500,2020,3153,2968,94.129997,2774,194
1400000US06037532605,6037532605,2020,352,197,55.970001,197,0
1400000US06037532607,6037532607,2020,2113,1971,93.279999,1838,133
1400000US06037532700,6037532700,2020,896,869,96.989998,818,51
1400000US06037532800,6037532800,2020,2746,2644,96.290001,2568,76
1400000US06037532900,6037532900,2020,1859,1811,97.419998,1762,49
1400000US06037533103,6037533103,2020,2817,2554,90.660004,2353,201
1400000US06037533108,6037533108,2020,2367,2285,96.540001,2166,119
1400000US06037533201,6037533201,2020,528,486,92.050003,456,30
1400000US06037533204,6037533204,2020,516,452,87.599998,426,26
1400000US06037533402,6037533402,2020,1194,1106,92.629997,1005,101
1400000US06037533403,6037533403,2020,1580,1477,93.480003,1394,83
1400000US06037533501,6037533501,2020,1352,1292,95.559998,1190,102
1400000US06037533504,6037533504,2020,820,753,91.830002,661,92
1400000US06037533601,6037533601,2020,833,778,93.400002,718,60
1400000US06037533602,6037533602,2020,2556,2309,90.339996,2132,177
1400000US06037533603,6037533603,2020,2263,2084,92.089996,1874,210
1400000US06037533701,6037533701,2020,1349,1251,92.739998,1143,108
1400000US06037533703,6037533703,2020,562,505,89.860001,468,37
1400000US06037533804,6037533804,2020,635,568,89.449997,510,58
1400000US06037533901,6037533901,2020,3352,2974,88.720001,2647,327
1400000US06037533902,6037533902,2020,596,499,83.720001,473,26
1400000US06037534001,6037534001,2020,769,727,94.540001,672,55
1400000US06037534002,6037534002,2020,808,712,88.120003,637,75
1400000US06037534102,6037534102,2020,1076,997,92.660004,941,56
1400000US06037534201,6037534201,2020,915,774,84.589996,719,55
1400000US06037534302,6037534302,2020,382,357,93.459999,320,37
1400000US06037534404,6037534404,2020,1241,1124,90.57,1056,68
1400000US06037534405,6037534405,2020,1651,1596,96.669998,1540,56
1400000US06037534406,6037534406,2020,1279,1200,93.82,1115,85
1400000US06037534501,6037534501,2020,943,866,91.830002,791,75
1400000US06037534803,6037534803,2020,590,554,93.900002,530,24
1400000US06037534804,6037534804,2020,466,457,98.07,383,74
1400000US06037534900,6037534900,2020,2597,2453,94.459999,2189,264
1400000US06037535001,6037535001,2020,1623,1547,95.32,1507,40
1400000US06037535101,6037535101,2020,2751,2628,95.529999,2462,166
1400000US06037535102,6037535102,2020,678,662,97.639999,619,43
1400000US06037535300,6037535300,2020,1182,1089,92.129997,1029,60
1400000US06037535501,6037535501,2020,557,531,95.330002,489,42
1400000US06037535603,6037535603,2020,492,467,94.919998,436,31
1400000US06037535604,6037535604,2020,503,477,94.830002,439,38
1400000US06037535605,6037535605,2020,1410,1285,91.129997,1102,183
1400000US06037535607,6037535607,2020,4144,3813,92.010002,3502,311
1400000US06037535701,6037535701,2020,612,587,95.919998,542,45
1400000US06037535702,6037535702,2020,2904,2599,89.5,2375,224
1400000US06037535803,6037535803,2020,386,368,95.339996,346,22
1400000US06037535901,6037535901,2020,1587,1392,87.709999,1258,134
1400000US06037536000,6037536000,2020,2448,2114,86.360001,1887,227
1400000US06037536103,6037536103,2020,552,473,85.690002,422,51
1400000US06037536104,6037536104,2020,1925,1648,85.610001,1459,189
1400000US06037536201,6037536201,2020,929,848,91.279999,707,141
1400000US06037540000,6037540000,2020,2575,2360,91.650002,2108,252
1400000US06037540101,6037540101,2020,3065,2679,87.410004,2340,339
1400000US06037540202,6037540202,2020,1886,1696,89.93,1540,156
1400000US06037540203,6037540203,2020,528,483,91.480003,438,45
1400000US06037540300,6037540300,2020,415,386,93.010002,353,33
1400000US06037540400,6037540400,2020,339,329,97.050003,316,13
1400000US06037540502,6037540502,2020,649,623,95.989998,579,44
1400000US06037540600,6037540600,2020,475,456,96,438,18
1400000US06037540700,6037540700,2020,2302,2117,91.959999,1948,169
1400000US06037540800,6037540800,2020,1515,1327,87.589996,1227,100
1400000US06037540901,6037540901,2020,635,605,95.279999,585,20
1400000US06037540902,6037540902,2020,1112,991,89.120003,912,79
1400000US06037541003,6037541003,2020,537,408,75.980003,344,64
1400000US06037541100,6037541100,2020,466,434,93.129997,383,51
1400000US06037541200,6037541200,2020,909,845,92.959999,763,82
1400000US06037541300,6037541300,2020,1419,1346,94.860001,1203,143
1400000US06037541401,6037541401,2020,553,532,96.199997,489,43
1400000US06037541500,6037541500,2020,765,731,95.559998,668,63
1400000US06037541603,6037541603,2020,955,910,95.290001,866,44
1400000US06037541605,6037541605,2020,572,552,96.5,509,43
1400000US06037541700,6037541700,2020,3412,3173,93,2874,299
1400000US06037541802,6037541802,2020,568,528,92.959999,471,57
1400000US06037542000,6037542000,2020,1284,1205,93.849998,1120,85
1400000US06037542104,6037542104,2020,584,564,96.580002,536,28
1400000US06037542106,6037542106,2020,3182,2952,92.769997,2724,228
1400000US06037542200,6037542200,2020,935,881,94.220001,816,65
1400000US06037542401,6037542401,2020,684,621,90.790001,558,63
1400000US06037542402,6037542402,2020,2206,2099,95.150002,1926,173
1400000US06037542601,6037542601,2020,591,548,92.720001,515,33
1400000US06037542700,6037542700,2020,1262,1155,91.519997,1084,71
1400000US06037542800,6037542800,2020,744,718,96.510002,651,67
1400000US06037542900,6037542900,2020,653,608,93.110001,534,74
1400000US06037543000,6037543000,2020,713,667,93.550003,582,85
1400000US06037543100,6037543100,2020,927,866,93.419998,781,85
1400000US06037543201,6037543201,2020,720,680,94.440002,636,44
1400000US06037543203,6037543203,2020,243,229,94.239998,215,14
1400000US06037543304,6037543304,2020,262,227,86.639999,210,17
1400000US06037543306,6037543306,2020,310,222,71.610001,179,43
1400000US06037543321,6037543321,2020,650,306,47.080002,247,59
1400000US06037543322,6037543322,2020,1435,1134,79.019997,1049,85
1400000US06037543400,6037543400,2020,302,232,76.82,191,41
1400000US06037543501,6037543501,2020,1703,1229,72.169998,1020,209
1400000US06037543503,6037543503,2020,978,859,87.830002,783,76
1400000US06037543601,6037543601,2020,868,629,72.470001,500,129
1400000US06037543607,6037543607,2020,384,264,68.75,186,78
1400000US06037543701,6037543701,2020,3014,2253,74.75,1770,483
1400000US06037543705,6037543705,2020,467,408,87.370003,367,41
1400000US06037543801,6037543801,2020,650,512,78.769997,420,92
1400000US06037543903,6037543903,2020,1171,933,79.68,770,163
1400000US06037544001,6037544001,2020,466,397,85.190002,357,40
1400000US06037544002,6037544002,2020,807,617,76.459999,530,87
1400000US06037550101,6037550101,2020,314,230,73.25,162,68
1400000US06037550201,6037550201,2020,266,185,69.550003,152,33
1400000US06037550202,6037550202,2020,364,251,68.959999,194,57
1400000US06037550301,6037550301,2020,463,313,67.599998,230,83
1400000US06037550501,6037550501,2020,681,457,67.110001,359,98
1400000US06037550602,6037550602,2020,746,466,62.470001,372,94
1400000US06037550700,6037550700,2020,2108,1357,64.370003,1040,317
1400000US06037550801,6037550801,2020,756,511,67.589996,411,100
1400000US06037550901,6037550901,2020,4131,2665,64.510002,2016,649
1400000US06037551001,6037551001,2020,810,465,57.41,381,84
1400000US06037551002,6037551002,2020,1418,928,65.440002,731,197
1400000US06037551101,6037551101,2020,561,475,84.669998,401,74
1400000US06037551102,6037551102,2020,227,163,71.809998,143,20
1400000US06037551201,6037551201,2020,513,374,72.900002,302,72
1400000US06037551203,6037551203,2020,1138,874,76.800003,688,186
1400000US06037551204,6037551204,2020,675,529,78.370003,416,113
1400000US06037551300,6037551300,2020,3459,2316,66.959999,1725,591
1400000US06037551402,6037551402,2020,678,477,70.349998,368,109
1400000US06037551501,6037551501,2020,2004,1472,73.449997,1100,372
1400000US06037551700,6037551700,2020,500,399,79.800003,324,75
1400000US06037551801,6037551801,2020,308,208,67.529999,170,38
1400000US06037551802,6037551802,2020,864,621,71.879997,506,115
1400000US06037551900,6037551900,2020,316,293,92.720001,261,32
1400000US06037552001,6037552001,2020,380,331,87.110001,319,12
1400000US06037552100,6037552100,2020,3373,2805,83.160004,2544,261
1400000US06037552200,6037552200,2020,332,307,92.470001,287,20
1400000US06037552301,6037552301,2020,417,365,87.529999,340,25
1400000US06037552302,6037552302,2020,1215,1028,84.610001,949,79
1400000US06037552601,6037552601,2020,446,422,94.620003,394,28
1400000US06037552602,6037552602,2020,504,445,88.290001,421,24
1400000US06037552700,6037552700,2020,540,486,90,469,17
1400000US06037552800,6037552800,2020,1947,1677,86.129997,1517,160
1400000US06037553000,6037553000,2020,517,455,88.010002,414,41
1400000US06037553100,6037553100,2020,2729,2022,74.089996,1683,339
1400000US06037553300,6037553300,2020,360,299,83.059998,250,49
1400000US06037553502,6037553502,2020,5508,5250,95.32,4573,677
1400000US06037553504,6037553504,2020,589,559,94.910004,490,69
1400000US06037553601,6037553601,2020,502,483,96.220001,434,49
1400000US06037553701,6037553701,2020,508,490,96.459999,446,44
1400000US06037553702,6037553702,2020,1341,1301,97.019997,1161,140
1400000US06037553802,6037553802,2020,1188,1120,94.279999,947,173
1400000US06037553901,6037553901,2020,984,913,92.779999,767,146
1400000US06037553902,6037553902,2020,1486,1420,95.559998,1225,195
1400000US06037554002,6037554002,2020,710,583,82.110001,528,55
1400000US06037554106,6037554106,2020,477,422,88.470001,369,53
1400000US06037554201,6037554201,2020,663,567,85.519997,499,68
1400000US06037554405,6037554405,2020,718,509,70.889999,438,71
1400000US06037554511,6037554511,2020,2009,550,27.379999,436,114
1400000US06037554512,6037554512,2020,1587,399,25.139999,332,67
1400000US06037554514,6037554514,2020,548,385,70.260002,334,51
1400000US06037554515,6037554515,2020,762,257,33.73,220,37
1400000US06037554516,6037554516,2020,3966,1492,37.619999,1183,309
1400000US06037554517,6037554517,2020,757,156,20.610001,131,25
1400000US06037554518,6037554518,2020,674,138,20.469999,101,37
1400000US06037554521,6037554521,2020,1929,1062,55.049999,879,183
1400000US06037554522,6037554522,2020,1186,570,48.060001,483,87
1400000US06037554700,6037554700,2020,292,279,95.550003,270,9
1400000US06037554801,6037554801,2020,670,459,68.510002,403,56
1400000US06037554802,6037554802,2020,1570,978,62.290001,789,189
1400000US06037555001,6037555001,2020,418,360,86.120003,324,36
1400000US06037555002,6037555002,2020,337,278,82.489998,240,38
1400000US06037555105,6037555105,2020,1965,1447,73.639999,1281,166
1400000US06037555106,6037555106,2020,415,382,92.050003,350,32
1400000US06037555107,6037555107,2020,414,381,92.029999,352,29
1400000US06037555211,6037555211,2020,346,327,94.510002,300,27
1400000US06037555212,6037555212,2020,323,311,96.279999,297,14
1400000US06037555300,6037555300,2020,384,279,72.660004,202,77
1400000US06037570001,6037570001,2020,3543,1928,54.419998,1597,331
1400000US06037570002,6037570002,2020,587,503,85.690002,457,46
1400000US06037570100,6037570100,2020,558,525,94.089996,460,65
1400000US06037570202,6037570202,2020,924,816,88.309998,719,97
1400000US06037570203,6037570203,2020,602,532,88.370003,483,49
1400000US06037570402,6037570402,2020,1020,884,86.669998,803,81
1400000US06037570403,6037570403,2020,685,606,88.470001,544,62
1400000US06037570504,6037570504,2020,3322,2717,81.790001,2418,299
1400000US06037570601,6037570601,2020,575,478,83.129997,440,38
1400000US06037570602,6037570602,2020,848,732,86.32,647,85
1400000US06037570701,6037570701,2020,826,697,84.379997,595,102
1400000US06037570800,6037570800,2020,1413,744,52.650002,624,120
1400000US06037570902,6037570902,2020,675,351,52,285,66
1400000US06037571000,6037571000,2020,450,148,32.889999,124,24
1400000US06037571101,6037571101,2020,344,182,52.91,150,32
1400000US06037571102,6037571102,2020,3195,1840,57.59,1568,272
1400000US06037571202,6037571202,2020,1411,784,55.560001,637,147
1400000US06037571300,6037571300,2020,1124,813,72.330002,659,154
1400000US06037571400,6037571400,2020,389,233,59.900002,179,54
1400000US06037571502,6037571502,2020,512,442,86.330002,398,44
1400000US06037571701,6037571701,2020,1686,1448,85.879997,1320,128
1400000US06037571703,6037571703,2020,859,741,86.260002,702,39
1400000US06037571800,6037571800,2020,526,248,47.150002,201,47
1400000US06037571900,6037571900,2020,2390,1299,54.349998,1077,222
1400000US06037572202,6037572202,2020,1465,1179,80.480003,1089,90
1400000US06037572500,6037572500,2020,541,464,85.769997,393,71
1400000US06037572600,6037572600,2020,772,667,86.400002,589,78
1400000US06037572700,6037572700,2020,670,559,83.43,496,63
1400000US06037573101,6037573101,2020,896,779,86.940002,715,64
1400000US06037573201,6037573201,2020,784,716,91.330002,647,69
1400000US06037573300,6037573300,2020,387,320,82.690002,270,50
1400000US06037573402,6037573402,2020,1537,1332,86.660004,1217,115
1400000US06037573601,6037573601,2020,412,166,40.290001,140,26
1400000US06037573700,6037573700,2020,855,225,26.32,154,71
1400000US06037573800,6037573800,2020,1143,512,44.790001,409,103
1400000US06037573902,6037573902,2020,781,169,21.639999,144,25
1400000US06037574000,6037574000,2020,950,281,29.58,228,53
1400000US06037574100,6037574100,2020,1456,563,38.669998,455,108
1400000US06037574201,6037574201,2020,459,239,52.07,204,35
1400000US06037574202,6037574202,2020,118,89,75.419998,85,4
1400000US06037574300,6037574300,2020,1777,620,34.889999,504,116
1400000US06037574400,6037574400,2020,3828,1362,35.580002,1142,220
1400000US06037574500,6037574500,2020,722,298,41.27,236,62
1400000US06037574602,6037574602,2020,382,148,38.740002,124,24
1400000US06037574901,6037574901,2020,561,137,24.42,110,27
1400000US06037575001,6037575001,2020,351,269,76.639999,249,20
1400000US06037575002,6037575002,2020,335,266,79.400002,227,39
1400000US06037575101,6037575101,2020,760,677,89.080002,633,44
1400000US06037575201,6037575201,2020,842,731,86.82,678,53
1400000US06037575300,6037575300,2020,4933,3305,67,3057,248
1400000US06037575401,6037575401,2020,1606,1221,76.029999,1181,40
1400000US06037575402,6037575402,2020,111,71,63.959999,68,3
1400000US06037575901,6037575901,2020,505,451,89.309998,420,31
1400000US06037576200,6037576200,2020,913,768,84.120003,709,59
1400000US06037576301,6037576301,2020,1087,832,76.540001,772,60
1400000US06037576401,6037576401,2020,964,915,94.919998,878,37
1400000US06037576501,6037576501,2020,1258,1112,88.389999,1043,69
1400000US06037576801,6037576801,2020,650,565,86.919998,513,52
1400000US06037576903,6037576903,2020,614,571,93,538,33
1400000US06037577000,6037577000,2020,4673,2851,61.009998,2644,207
1400000US06037577100,6037577100,2020,866,444,51.27,374,70
1400000US06037577501,6037577501,2020,335,69,20.6,61,8
1400000US06037577602,6037577602,2020,332,102,30.719999,85,17
1400000US06037577606,6037577606,2020,1463,333,22.76,282,51
1400000US06037577700,6037577700,2020,1023,849,82.989998,716,133
1400000US06037577800,6037577800,2020,605,419,69.260002,299,120
1400000US06037577900,6037577900,2020,494,326,65.989998,289,37
1400000US06037578000,6037578000,2020,2713,2228,82.120003,2014,214
1400000US06037599000,6037599000,2020,507,363,71.599998,292,71
1400000US06037600201,6037600201,2020,877,825,94.07,807,18
1400000US06037600302,6037600302,2020,1881,1743,92.660004,1665,78
1400000US06037600303,6037600303,2020,721,709,98.339996,693,16
1400000US06037600501,6037600501,2020,253,210,83,207,3
1400000US06037600602,6037600602,2020,1306,988,75.650002,945,43
1400000US06037600702,6037600702,2020,257,205,79.769997,173,32
1400000US06037600703,6037600703,2020,607,555,91.43,482,73
1400000US06037600801,6037600801,2020,194,166,85.57,152,14
1400000US06037600911,6037600911,2020,514,482,93.769997,433,49
1400000US06037601001,6037601001,2020,86,51,59.299999,51,0
1400000US06037601002,6037601002,2020,451,382,84.699997,338,44
1400000US06037601202,6037601202,2020,1122,1016,90.550003,884,132
1400000US06037601211,6037601211,2020,1530,1382,90.330002,1228,154
1400000US06037601212,6037601212,2020,385,363,94.290001,294,69
1400000US06037601301,6037601301,2020,781,478,61.200001,443,35
1400000US06037601303,6037601303,2020,1067,869,81.440002,742,127
1400000US06037601401,6037601401,2020,523,463,88.529999,432,31
1400000US06037601402,6037601402,2020,488,455,93.239998,398,57
1400000US06037601502,6037601502,2020,1384,1309,94.580002,1156,153
1400000US06037601600,6037601600,2020,2108,1922,91.18,1681,241
1400000US06037601700,6037601700,2020,1984,1771,89.260002,1514,257
1400000US06037601802,6037601802,2020,574,542,94.43,484,58
1400000US06037602003,6037602003,2020,350,317,90.57,288,29
1400000US06037602104,6037602104,2020,488,428,87.699997,377,51
1400000US06037602106,6037602106,2020,1452,1216,83.75,1044,172
1400000US06037602201,6037602201,2020,3315,2043,61.630001,1774,269
1400000US06037602302,6037602302,2020,1891,732,38.709999,546,186
1400000US06037602402,6037602402,2020,748,527,70.449997,442,85
1400000US06037602403,6037602403,2020,1392,1185,85.129997,1048,137
1400000US06037602404,6037602404,2020,557,514,92.279999,451,63
1400000US06037602505,6037602505,2020,799,709,88.739998,627,82
1400000US06037602506,6037602506,2020,732,652,89.07,578,74
1400000US06037602511,6037602511,2020,1666,1492,89.559998,1347,145
1400000US06037602601,6037602601,2020,439,360,82,344,16
1400000US06037602700,6037602700,2020,262,205,78.239998,192,13
1400000US06037602801,6037602801,2020,1140,1069,93.769997,994,75
1400000US06037602802,6037602802,2020,1102,1018,92.379997,923,95
1400000US06037603006,6037603006,2020,408,358,87.75,324,34
1400000US06037603008,6037603008,2020,735,666,90.610001,605,61
1400000US06037603200,6037603200,2020,1344,1252,93.150002,1097,155
1400000US06037603301,6037603301,2020,1933,1581,81.790001,1428,153
1400000US06037603400,6037603400,2020,759,553,72.860001,476,77
1400000US06037603702,6037603702,2020,566,384,67.839996,317,67
1400000US06037603705,6037603705,2020,163,144,88.339996,135,9
1400000US06037603706,6037603706,2020,554,498,89.889999,453,45
1400000US06037603801,6037603801,2020,1835,1517,82.669998,1395,122
1400000US06037603802,6037603802,2020,1633,1365,83.589996,1204,161
1400000US06037603901,6037603901,2020,3254,2660,81.75,2343,317
1400000US06037603902,6037603902,2020,859,704,81.959999,615,89
1400000US06037604001,6037604001,2020,504,401,79.559998,345,56
1400000US06037604002,6037604002,2020,614,523,85.18,467,56
1400000US06037604200,6037604200,2020,1594,1366,85.699997,1216,150
1400000US06037620001,6037620001,2020,746,71,9.5200005,56,15
1400000US06037620002,6037620002,2020,838,140,16.709999,102,38
1400000US06037620101,6037620101,2020,1855,290,15.63,222,68
1400000US06037620303,6037620303,2020,576,16,2.78,15,1
1400000US06037620305,6037620305,2020,642,17,2.6500001,17,0
1400000US06037620400,6037620400,2020,1857,86,4.6300001,78,8
1400000US06037620501,6037620501,2020,656,73,11.13,58,15
1400000US06037620521,6037620521,2020,464,97,20.91,78,19
1400000US06037620602,6037620602,2020,1899,395,20.799999,300,95
1400000US06037620701,6037620701,2020,474,57,12.03,52,5
1400000US06037620703,6037620703,2020,585,26,4.4400001,25,1
1400000US06037620802,6037620802,2020,2892,162,5.5999999,147,15
1400000US06037620904,6037620904,2020,357,15,4.1999998,15,0
1400000US06037621005,6037621005,2020,1338,68,5.0799999,63,5
1400000US06037621201,6037621201,2020,4741,725,15.29,599,126
1400000US06037621301,6037621301,2020,640,46,7.1900001,37,9
1400000US06037621400,6037621400,2020,453,61,13.47,53,8
1400000US06037650001,6037650001,2020,1131,412,36.43,340,72
1400000US06037650004,6037650004,2020,336,189,56.25,159,30
1400000US06037650101,6037650101,2020,566,193,34.099998,161,32
1400000US06037650200,6037650200,2020,2496,1060,42.470001,853,207
1400000US06037650300,6037650300,2020,585,290,49.57,229,61
1400000US06037650401,6037650401,2020,1248,372,29.809999,314,58
1400000US06037650502,6037650502,2020,1263,199,15.76,168,31
1400000US06037650603,6037650603,2020,2931,682,23.27,580,102
1400000US06037650701,6037650701,2020,646,138,21.360001,108,30
1400000US06037650702,6037650702,2020,650,66,10.15,53,13
1400000US06037650903,6037650903,2020,1846,602,32.610001,475,127
1400000US06037650904,6037650904,2020,611,404,66.120003,360,44
1400000US06037651001,6037651001,2020,695,345,49.639999,294,51
1400000US06037651002,6037651002,2020,808,309,38.240002,261,48
1400000US06037651101,6037651101,2020,935,146,15.61,114,32
1400000US06037651201,6037651201,2020,516,69,13.37,56,13
1400000US06037651221,6037651221,2020,691,132,19.1,118,14
1400000US06037651222,6037651222,2020,2640,466,17.65,386,80
1400000US06037651302,6037651302,2020,1376,183,13.3,157,26
1400000US06037651402,6037651402,2020,649,104,16.02,85,19
1400000US06037670002,6037670002,2020,1317,1110,84.279999,1022,88
1400000US06037670003,6037670003,2020,913,638,69.879997,522,116
1400000US06037670101,6037670101,2020,437,388,88.790001,366,22
1400000US06037670202,6037670202,2020,401,51,12.72,46,5
1400000US06037670324,6037670324,2020,635,45,7.0900002,45,0
1400000US06037670326,6037670326,2020,430,25,5.8099999,21,4
1400000US06037670328,6037670328,2020,2723,154,5.6599998,137,17
1400000US06037670405,6037670405,2020,929,72,7.75,68,4
1400000US06037670413,6037670413,2020,394,30,7.6100001,27,3
1400000US06037670416,6037670416,2020,314,40,12.74,32,8
1400000US06037670417,6037670417,2020,2668,234,8.7700005,218,16
1400000US06037670418,6037670418,2020,936,45,4.8099999,39,6
1400000US06037670500,6037670500,2020,43,10,23.26,8,2
1400000US06037670604,6037670604,2020,365,27,7.4000001,24,3
1400000US06037670701,6037670701,2020,2016,1263,62.650002,978,285
1400000US06037670702,6037670702,2020,908,113,12.44,93,20
1400000US06037700200,6037700200,2020,1808,886,49,714,172
1400000US06037700400,6037700400,2020,290,137,47.240002,112,25
1400000US06037700501,6037700501,2020,385,74,19.219999,64,10
1400000US06037700600,6037700600,2020,599,69,11.52,61,8
1400000US06037700901,6037700901,2020,676,127,18.790001,113,14
1400000US06037700902,6037700902,2020,962,178,18.5,149,29
1400000US06037701000,6037701000,2020,1262,228,18.07,210,18
1400000US06037701304,6037701304,2020,740,101,13.65,79,22
1400000US06037701501,6037701501,2020,1116,238,21.33,188,50
1400000US06037701601,6037701601,2020,727,41,5.6399999,33,8
1400000US06037701602,6037701602,2020,438,155,35.389999,126,29
1400000US06037701801,6037701801,2020,423,175,41.369999,150,25
1400000US06037701902,6037701902,2020,2730,861,31.540001,717,144
1400000US06037702002,6037702002,2020,540,184,34.07,156,28
1400000US06037702201,6037702201,2020,1479,617,41.720001,499,118
1400000US06037702300,6037702300,2020,571,181,31.700001,139,42
1400000US06037702400,6037702400,2020,584,162,27.74,136,26
1400000US06037702600,6037702600,2020,1409,268,19.02,225,43
1400000US06037702700,6037702700,2020,4412,1400,31.73,1178,222
1400000US06037702801,6037702801,2020,570,304,53.330002,282,22
1400000US06037702803,6037702803,2020,600,380,63.330002,320,60
1400000US06037703002,6037703002,2020,490,339,69.18,279,60
1400000US06037703100,6037703100,2020,494,408,82.589996,385,23
1400000US06037703200,6037703200,2020,315,276,87.620003,268,8
1400000US06037800101,6037800101,2020,3341,382,11.43,340,42
1400000US06037800103,6037800103,2020,290,50,17.24,48,2
1400000US06037800202,6037800202,2020,1287,137,10.64,120,17
1400000US06037800205,6037800205,2020,530,100,18.870001,86,14
1400000US06037800206,6037800206,2020,525,40,7.6199999,35,5
1400000US06037800325,6037800325,2020,420,32,7.6199999,26,6
1400000US06037800334,6037800334,2020,2627,367,13.97,331,36
1400000US06037800338,6037800338,2020,1934,218,11.27,174,44
1400000US06037800406,6037800406,2020,54,54,100,54,0
1400000US06037800411,6037800411,2020,840,123,14.64,113,10
1400000US06037800412,6037800412,2020,272,42,15.44,36,6
1400000US06037800504,6037800504,2020,263,36,13.69,33,3
1400000US06037900102,6037900102,2020,674,622,92.279999,571,51
1400000US06037900103,6037900103,2020,539,510,94.620003,468,42
1400000US06037900104,6037900104,2020,518,428,82.629997,400,28
1400000US06037900301,6037900301,2020,769,727,94.540001,694,33
1400000US06037900501,6037900501,2020,587,559,95.230003,532,27
1400000US06037900504,6037900504,2020,4655,3957,85.010002,3518,439
1400000US06037900505,6037900505,2020,693,659,95.089996,572,87
1400000US06037900508,6037900508,2020,2445,2144,87.690002,1847,297
1400000US06037900510,6037900510,2020,1349,1294,95.919998,1278,16
1400000US06037900602,6037900602,2020,960,918,95.629997,846,72
1400000US06037900606,6037900606,2020,2901,2486,85.690002,2302,184
1400000US06037900607,6037900607,2020,642,610,95.019997,561,49
1400000US06037900609,6037900609,2020,773,705,91.199997,627,78
1400000US06037900610,6037900610,2020,637,596,93.559998,585,11
1400000US06037900701,6037900701,2020,1094,970,88.669998,895,75
1400000US06037900703,6037900703,2020,1239,1070,86.360001,963,107
1400000US06037900804,6037900804,2020,545,517,94.860001,462,55
1400000US06037900805,6037900805,2020,760,680,89.470001,584,96
1400000US06037900807,6037900807,2020,713,673,94.389999,612,61
1400000US06037900901,6037900901,2020,864,420,48.610001,354,66
1400000US06037901007,6037901007,2020,743,455,61.240002,415,40
1400000US06037901009,6037901009,2020,994,864,86.919998,731,133
1400000US06037901010,6037901010,2020,780,633,81.150002,513,120
1400000US06037901011,6037901011,2020,724,567,78.309998,455,112
1400000US06037901012,6037901012,2020,836,600,71.769997,499,101
1400000US06037901013,6037901013,2020,1161,739,63.650002,550,189
1400000US06037901014,6037901014,2020,2562,1670,65.18,1495,175
1400000US06037901101,6037901101,2020,1005,451,44.880001,410,41
1400000US06037901209,6037901209,2020,334,214,64.07,187,27
1400000US06037901214,6037901214,2020,965,553,57.310001,478,75
1400000US06037901215,6037901215,2020,3529,1607,45.540001,1361,246
1400000US06037901217,6037901217,2020,87,22,25.290001,19,3
1400000US06037901300,6037901300,2020,512,497,97.07,488,9
1400000US06037910002,6037910002,2020,270,204,75.559998,186,18
1400000US06037910210,6037910210,2020,1051,513,48.810001,449,64
1400000US06037910212,6037910212,2020,886,205,23.139999,180,25
1400000US06037910214,6037910214,2020,4284,3072,71.709999,2626,446
1400000US06037910215,6037910215,2020,1704,1457,85.5,1208,249
1400000US06037910217,6037910217,2020,744,421,56.59,363,58
1400000US06037910218,6037910218,2020,571,428,74.959999,387,41
1400000US06037910301,6037910301,2020,871,555,63.720001,503,52
1400000US06037910302,6037910302,2020,1789,845,47.23,743,102
1400000US06037910401,6037910401,2020,653,540,82.699997,430,110
1400000US06037910404,6037910404,2020,535,505,94.389999,457,48
1400000US06037910405,6037910405,2020,1415,1269,89.68,1098,171
1400000US06037910504,6037910504,2020,696,682,97.989998,641,41
1400000US06037910601,6037910601,2020,610,571,93.610001,511,60
1400000US06037910602,6037910602,2020,5714,4912,85.959999,4278,634
1400000US06037910605,6037910605,2020,880,829,94.199997,729,100
1400000US06037910606,6037910606,2020,141,124,87.940002,112,12
1400000US06037910608,6037910608,2020,623,599,96.150002,529,70
1400000US06037910706,6037910706,2020,760,698,91.839996,595,103
1400000US06037910712,6037910712,2020,542,500,92.25,436,64
1400000US06037910714,6037910714,2020,1745,1525,87.389999,1356,169
1400000US06037910715,6037910715,2020,576,544,94.440002,484,60
1400000US06037910716,6037910716,2020,1637,1504,91.879997,1285,219
1400000US06037910717,6037910717,2020,4368,3459,79.190002,2786,673
1400000US06037910718,6037910718,2020,1517,1379,90.900002,1100,279
1400000US06037910720,6037910720,2020,676,644,95.269997,560,84
1400000US06037910804,6037910804,2020,3504,1027,29.309999,944,83
1400000US06037910807,6037910807,2020,1003,534,53.240002,452,82
1400000US06037910814,6037910814,2020,225,94,41.779999,90,4
1400000US06037910815,6037910815,2020,1165,659,56.57,551,108
1400000US06037911001,6037911001,2020,914,711,77.790001,674,37
1400000US06037911100,6037911100,2020,2305,1842,79.910004,1638,204
1400000US06037920013,6037920013,2020,852,125,14.67,104,21
1400000US06037920015,6037920015,2020,847,90,10.63,72,18
1400000US06037920017,6037920017,2020,980,225,22.959999,195,30
1400000US06037920020,6037920020,2020,712,202,28.370001,162,40
1400000US06037920029,6037920029,2020,2531,1032,40.77,845,187
1400000US06037920031,6037920031,2020,3247,1712,52.73,1418,294
1400000US06037920034,6037920034,2020,1032,582,56.400002,489,93
1400000US06037920035,6037920035,2020,495,392,79.190002,340,52
1400000US06037920041,6037920041,2020,1821,636,34.93,548,88
1400000US06037920042,6037920042,2020,595,396,66.550003,349,47
1400000US06037920043,6037920043,2020,1502,459,30.559999,389,70
1400000US06037920044,6037920044,2020,2499,447,17.889999,376,71
1400000US06037920048,6037920048,2020,2029,1207,59.490002,1014,193
1400000US06037920049,6037920049,2020,718,117,16.299999,111,6
1400000US06037920102,6037920102,2020,703,271,38.549999,253,18
1400000US06037920104,6037920104,2020,313,93,29.709999,73,20
1400000US06037920109,6037920109,2020,605,89,14.71,71,18
1400000US06037920111,6037920111,2020,350,117,33.43,100,17
1400000US06037920112,6037920112,2020,1298,218,16.799999,186,32
1400000US06037920115,6037920115,2020,1461,218,14.92,188,30
1400000US06037920118,6037920118,2020,1952,522,26.74,473,49
1400000US06037920119,6037920119,2020,468,83,17.74,79,4
1400000US06037920120,6037920120,2020,576,77,13.37,69,8
1400000US06037920121,6037920121,2020,5236,754,14.4,669,85
1400000US06037920313,6037920313,2020,909,559,61.5,497,62
1400000US06037920314,6037920314,2020,582,221,37.970001,200,21
1400000US06037920322,6037920322,2020,434,173,39.860001,149,24
1400000US06037920326,6037920326,2020,850,169,19.879999,134,35
1400000US06037920329,6037920329,2020,878,220,25.059999,180,40
1400000US06037920330,6037920330,2020,402,52,12.94,41,11
1400000US06037920334,6037920334,2020,684,100,14.62,88,12
1400000US06037920338,6037920338,2020,761,81,10.64,69,12
1400000US06037920339,6037920339,2020,3770,529,14.03,449,80
1400000US06037920340,6037920340,2020,3245,1381,42.560001,1233,148
1400000US06037920341,6037920341,2020,609,535,87.849998,480,55
1400000US06037920342,6037920342,2020,596,507,85.07,441,66
1400000US06037930400,6037930400,2020,109,34,31.190001,31,3
1400000US06037980004,6037980004,2020,744,738,99.190002,688,50
1400000US06037980013,6037980013,2020,1136,515,45.330002,411,104
1400000US06037980016,6037980016,2020,206,200,97.089996,194,6
1400000US06037101110,6037101110,2019,1272,948,74.529999,774,174
1400000US06037101220,6037101220,2019,205,171,83.410004,165,6
1400000US06037101300,6037101300,2019,380,259,68.160004,206,53
1400000US06037102107,6037102107,2019,798,653,81.830002,538,115
1400000US06037103101,6037103101,2019,828,638,77.050003,545,93
1400000US06037103102,6037103102,2019,690,567,82.169998,506,61
1400000US06037103202,6037103202,2019,160,130,81.25,115,15
1400000US06037103402,6037103402,2019,418,238,56.939999,191,47
1400000US06037104103,6037104103,2019,721,663,91.959999,536,127
1400000US06037104105,6037104105,2019,1008,851,84.419998,723,128
1400000US06037104108,6037104108,2019,1359,1205,88.669998,1158,47
1400000US06037104124,6037104124,2019,1133,881,77.760002,733,148
1400000US06037104204,6037104204,2019,457,420,91.900002,405,15
1400000US06037104310,6037104310,2019,2960,2886,97.5,2556,330
1400000US06037104321,6037104321,2019,1189,998,83.940002,946,52
1400000US06037104401,6037104401,2019,647,583,90.110001,560,23
1400000US06037104500,6037104500,2019,745,649,87.110001,620,29
1400000US06037104821,6037104821,2019,799,738,92.370003,671,67
1400000US06037104822,6037104822,2019,1114,950,85.279999,897,53
1400000US06037106020,6037106020,2019,249,180,72.290001,175,5
1400000US06037106112,6037106112,2019,540,465,86.110001,396,69
1400000US06037106113,6037106113,2019,378,296,78.309998,236,60
1400000US06037106114,6037106114,2019,397,318,80.099998,288,30
1400000US06037106403,6037106403,2019,2104,1773,84.269997,1575,198
1400000US06037106405,6037106405,2019,2613,2139,81.860001,1985,154
1400000US06037106510,6037106510,2019,127,127,100,127,0
1400000US06037106520,6037106520,2019,1706,1277,74.849998,1122,155
1400000US06037106603,6037106603,2019,456,193,42.32,137,56
1400000US06037106604,6037106604,2019,407,333,81.82,319,14
1400000US06037106641,6037106641,2019,1594,871,54.639999,680,191
1400000US06037106642,6037106642,2019,452,119,26.33,100,19
1400000US06037106646,6037106646,2019,2758,2032,73.68,1643,389
1400000US06037106648,6037106648,2019,329,267,81.160004,253,14
1400000US06037107020,6037107020,2019,638,555,86.989998,502,53
1400000US06037108104,6037108104,2019,725,135,18.620001,110,25
1400000US06037108202,6037108202,2019,1161,164,14.13,144,20
1400000US06037109200,6037109200,2019,340,240,70.589996,203,37
1400000US06037109300,6037109300,2019,580,406,70,325,81
1400000US06037109500,6037109500,2019,2030,1804,88.870003,1586,218
1400000US06037109601,6037109601,2019,652,486,74.540001,402,84
1400000US06037109700,6037109700,2019,1374,940,68.410004,758,182
1400000US06037109800,6037109800,2019,820,482,58.779999,343,139
1400000US06037111100,6037111100,2019,462,318,68.830002,249,69
1400000US06037111202,6037111202,2019,396,251,63.380001,204,47
1400000US06037111204,6037111204,2019,3003,1399,46.59,1064,335
1400000US06037111206,6037111206,2019,432,229,53.009998,175,54
1400000US06037111302,6037111302,2019,402,265,65.919998,218,47
1400000US06037111303,6037111303,2019,2294,1575,68.660004,1273,302
1400000US06037111304,6037111304,2019,4600,2396,52.09,1830,566
1400000US06037111401,6037111401,2019,463,298,64.360001,252,46
1400000US06037113101,6037113101,2019,509,311,61.099998,264,47
1400000US06037113212,6037113212,2019,387,257,66.410004,214,43
1400000US06037113232,6037113232,2019,347,286,82.419998,275,11
1400000US06037113303,6037113303,2019,591,355,60.07,313,42
1400000US06037113322,6037113322,2019,446,145,32.509998,118,27
1400000US06037113323,6037113323,2019,1440,882,61.25,758,124
1400000US06037113324,6037113324,2019,1757,1170,66.589996,1025,145
1400000US06037113423,6037113423,2019,160,126,78.75,117,9
1400000US06037113428,6037113428,2019,755,666,88.209999,626,40
1400000US06037115101,6037115101,2019,2595,1560,60.119999,1261,299
1400000US06037115103,6037115103,2019,1040,738,70.959999,628,110
1400000US06037115202,6037115202,2019,527,354,67.169998,285,69
1400000US06037115301,6037115301,2019,576,203,35.240002,171,32
1400000US06037115302,6037115302,2019,444,405,91.220001,388,17
1400000US06037115401,6037115401,2019,801,689,86.019997,660,29
1400000US06037115403,6037115403,2019,284,204,71.830002,177,27
1400000US06037115404,6037115404,2019,202,50,24.75,45,5
1400000US06037117101,6037117101,2019,2921,2651,90.760002,2511,140
1400000US06037117102,6037117102,2019,426,383,89.910004,327,56
1400000US06037117202,6037117202,2019,2384,2073,86.949997,1943,130
1400000US06037117302,6037117302,2019,527,440,83.489998,424,16
1400000US06037117303,6037117303,2019,264,104,39.389999,80,24
1400000US06037117407,6037117407,2019,586,561,95.730003,551,10
1400000US06037117510,6037117510,2019,496,449,90.519997,399,50
1400000US06037117520,6037117520,2019,631,581,92.080002,568,13
1400000US06037117530,6037117530,2019,807,734,90.949997,706,28
1400000US06037119003,6037119003,2019,623,585,93.900002,552,33
1400000US06037119004,6037119004,2019,564,428,75.889999,373,55
1400000US06037119201,6037119201,2019,1792,1556,86.830002,1422,134
1400000US06037119342,6037119342,2019,655,613,93.589996,580,33
1400000US06037119802,6037119802,2019,802,638,79.550003,560,78
1400000US06037119900,6037119900,2019,812,703,86.580002,623,80
1400000US06037120010,6037120010,2019,1165,1077,92.449997,1049,28
1400000US06037120020,6037120020,2019,743,686,92.330002,678,8
1400000US06037120030,6037120030,2019,1468,1341,91.349998,1262,79
1400000US06037120107,6037120107,2019,479,451,94.150002,447,4
1400000US06037120108,6037120108,2019,935,898,96.040001,878,20
1400000US06037120300,6037120300,2019,334,308,92.220001,294,14
1400000US06037120400,6037120400,2019,485,424,87.419998,389,35
1400000US06037121010,6037121010,2019,3992,3525,88.300003,3211,314
1400000US06037121020,6037121020,2019,516,452,87.599998,424,28
1400000US06037121102,6037121102,2019,289,254,87.889999,207,47
1400000US06037121210,6037121210,2019,381,293,76.900002,266,27
1400000US06037121222,6037121222,2019,2262,2056,90.889999,1890,166
1400000US06037121600,6037121600,2019,82,63,76.830002,55,8
1400000US06037121801,6037121801,2019,415,394,94.940002,383,11
1400000US06037121900,6037121900,2019,409,371,90.709999,338,33
1400000US06037122000,6037122000,2019,572,468,81.82,420,48
1400000US06037122122,6037122122,2019,553,504,91.139999,477,27
1400000US06037122200,6037122200,2019,281,246,87.540001,225,21
1400000US06037122420,6037122420,2019,513,472,92.010002,450,22
1400000US06037123010,6037123010,2019,1870,1710,91.440002,1619,91
1400000US06037123301,6037123301,2019,499,456,91.379997,431,25
1400000US06037123303,6037123303,2019,663,592,89.290001,567,25
1400000US06037123420,6037123420,2019,1735,1524,87.839996,1451,73
1400000US06037123510,6037123510,2019,775,702,90.580002,674,28
1400000US06037123601,6037123601,2019,2008,1701,84.709999,1531,170
1400000US06037123602,6037123602,2019,668,576,86.230003,529,47
1400000US06037123700,6037123700,2019,675,541,80.150002,471,70
1400000US06037123901,6037123901,2019,1951,1756,90.010002,1682,74
1400000US06037124102,6037124102,2019,736,623,84.650002,586,37
1400000US06037124201,6037124201,2019,749,661,88.25,623,38
1400000US06037124300,6037124300,2019,357,320,89.639999,297,23
1400000US06037124600,6037124600,2019,1829,866,47.349998,747,119
1400000US06037124700,6037124700,2019,562,193,34.34,172,21
1400000US06037124902,6037124902,2019,375,268,71.470001,238,30
1400000US06037125101,6037125101,2019,2486,1772,71.279999,1523,249
1400000US06037125102,6037125102,2019,647,162,25.040001,145,17
1400000US06037125310,6037125310,2019,750,477,63.599998,447,30
1400000US06037125322,6037125322,2019,362,312,86.190002,298,14
1400000US06037125600,6037125600,2019,463,317,68.470001,274,43
1400000US06037127210,6037127210,2019,2637,2378,90.18,2262,116
1400000US06037127400,6037127400,2019,503,450,89.459999,421,29
1400000US06037127603,6037127603,2019,715,664,92.870003,635,29
1400000US06037127803,6037127803,2019,328,134,40.849998,125,9
1400000US06037127805,6037127805,2019,470,437,92.980003,421,16
1400000US06037127806,6037127806,2019,2616,1991,76.110001,1837,154
1400000US06037127910,6037127910,2019,1212,817,67.410004,738,79
1400000US06037127920,6037127920,2019,705,643,91.209999,618,25
1400000US06037128102,6037128102,2019,887,761,85.790001,709,52
1400000US06037128302,6037128302,2019,741,690,93.120003,667,23
1400000US06037128602,6037128602,2019,502,242,48.209999,197,45
1400000US06037128802,6037128802,2019,2118,1505,71.059998,1330,175
1400000US06037128910,6037128910,2019,188,108,57.450001,92,16
1400000US06037131022,6037131022,2019,433,389,89.839996,371,18
1400000US06037131023,6037131023,2019,386,326,84.459999,310,16
1400000US06037131100,6037131100,2019,428,333,77.800003,299,34
1400000US06037131200,6037131200,2019,520,368,70.769997,303,65
1400000US06037131300,6037131300,2019,396,334,84.339996,311,23
1400000US06037131600,6037131600,2019,3378,2264,67.019997,2034,230
1400000US06037131701,6037131701,2019,57,29,50.880001,23,6
1400000US06037131801,6037131801,2019,938,813,86.669998,746,67
1400000US06037131900,6037131900,2019,382,328,85.860001,295,33
1400000US06037132001,6037132001,2019,385,302,78.440002,246,56
1400000US06037132002,6037132002,2019,6512,5261,80.790001,4636,625
1400000US06037132301,6037132301,2019,360,303,84.169998,274,29
1400000US06037132501,6037132501,2019,19,13,68.419998,12,1
1400000US06037132700,6037132700,2019,1908,1600,83.860001,1477,123
1400000US06037133000,6037133000,2019,401,324,80.800003,307,17
1400000US06037133101,6037133101,2019,387,321,82.949997,287,34
1400000US06037133102,6037133102,2019,2080,1153,55.43,895,258
1400000US06037134001,6037134001,2019,696,626,89.940002,613,13
1400000US06037134002,6037134002,2019,487,309,63.450001,252,57
1400000US06037134101,6037134101,2019,464,381,82.110001,363,18
1400000US06037134103,6037134103,2019,485,424,87.419998,398,26
1400000US06037134104,6037134104,2019,406,216,53.200001,214,2
1400000US06037134302,6037134302,2019,432,339,78.470001,289,50
1400000US06037134303,6037134303,2019,598,551,92.139999,538,13
1400000US06037134304,6037134304,2019,1108,957,86.370003,878,79
1400000US06037134421,6037134421,2019,596,146,24.5,127,19
1400000US06037134422,6037134422,2019,250,175,70,143,32
1400000US06037134423,6037134423,2019,379,138,36.41,114,24
1400000US06037134520,6037134520,2019,1422,1260,88.610001,1175,85
1400000US06037134522,6037134522,2019,739,659,89.169998,613,46
1400000US06037134720,6037134720,2019,1587,1353,85.260002,1268,85
1400000US06037134801,6037134801,2019,425,369,86.82,341,28
1400000US06037135102,6037135102,2019,316,149,47.150002,120,29
1400000US06037135202,6037135202,2019,811,133,16.4,114,19
1400000US06037135204,6037135204,2019,876,196,22.370001,176,20
1400000US06037137000,6037137000,2019,3489,1148,32.900002,984,164
1400000US06037137104,6037137104,2019,629,517,82.190002,449,68
1400000US06037137203,6037137203,2019,661,460,69.589996,412,48
1400000US06037137301,6037137301,2019,539,218,40.450001,194,24
1400000US06037137302,6037137302,2019,2151,816,37.939999,658,158
1400000US06037137401,6037137401,2019,648,119,18.360001,104,15
1400000US06037137402,6037137402,2019,411,90,21.9,81,9
1400000US06037137501,6037137501,2019,2981,1695,56.860001,1371,324
1400000US06037139001,6037139001,2019,312,101,32.369999,81,20
1400000US06037139200,6037139200,2019,361,239,66.199997,209,30
1400000US06037139301,6037139301,2019,700,499,71.290001,425,74
1400000US06037139402,6037139402,2019,3159,1182,37.419998,1013,169
1400000US06037139502,6037139502,2019,526,333,63.310001,293,40
1400000US06037139600,6037139600,2019,583,131,22.469999,119,12
1400000US06037139701,6037139701,2019,561,35,6.2399998,29,6
1400000US06037141101,6037141101,2019,728,174,23.9,150,24
1400000US06037141304,6037141304,2019,793,224,28.25,206,18
1400000US06037141400,6037141400,2019,546,84,15.38,75,9
1400000US06037143200,6037143200,2019,897,551,61.43,496,55
1400000US06037143302,6037143302,2019,1672,852,50.959999,731,121
1400000US06037143700,6037143700,2019,214,54,25.23,52,2
1400000US06037143801,6037143801,2019,992,124,12.5,115,9
1400000US06037181000,6037181000,2019,499,414,82.970001,375,39
1400000US06037181400,6037181400,2019,757,371,49.009998,283,88
1400000US06037181500,6037181500,2019,910,409,44.950001,366,43
1400000US06037181600,6037181600,2019,2256,1284,56.91,992,292
1400000US06037183101,6037183101,2019,1350,1085,80.370003,1021,64
1400000US06037183104,6037183104,2019,279,209,74.910004,185,24
1400000US06037183220,6037183220,2019,229,190,82.970001,173,17
1400000US06037183221,6037183221,2019,60,56,93.330002,56,0
1400000US06037183401,6037183401,2019,323,254,78.639999,236,18
1400000US06037183402,6037183402,2019,320,265,82.809998,237,28
1400000US06037183510,6037183510,2019,1428,1287,90.129997,1181,106
1400000US06037183520,6037183520,2019,336,311,92.559998,300,11
1400000US06037183702,6037183702,2019,188,158,84.040001,147,11
1400000US06037183810,6037183810,2019,561,517,92.160004,488,29
1400000US06037185101,6037185101,2019,555,411,74.050003,372,39
1400000US06037185102,6037185102,2019,457,350,76.589996,326,24
1400000US06037185204,6037185204,2019,444,62,13.96,51,11
1400000US06037185310,6037185310,2019,1146,1000,87.260002,954,46
1400000US06037186100,6037186100,2019,468,282,60.259998,213,69
1400000US06037186302,6037186302,2019,156,138,88.459999,120,18
1400000US06037186401,6037186401,2019,1986,1657,83.43,1520,137
1400000US06037186404,6037186404,2019,311,281,90.349998,270,11
1400000US06037187101,6037187101,2019,278,202,72.660004,178,24
1400000US06037187102,6037187102,2019,1549,1011,65.269997,864,147
1400000US06037187300,6037187300,2019,338,245,72.489998,219,26
1400000US06037188201,6037188201,2019,465,63,13.55,48,15
1400000US06037188300,6037188300,2019,282,197,69.860001,171,26
1400000US06037189201,6037189201,2019,473,395,83.510002,352,43
1400000US06037189501,6037189501,2019,263,168,63.880001,162,6
1400000US06037189905,6037189905,2019,400,212,53,186,26
1400000US06037190102,6037190102,2019,1446,1246,86.169998,1157,89
1400000US06037190510,6037190510,2019,470,438,93.190002,421,17
1400000US06037190701,6037190701,2019,107,95,88.790001,91,4
1400000US06037190901,6037190901,2019,1175,1052,89.529999,1002,50
1400000US06037190902,6037190902,2019,878,752,85.650002,715,37
1400000US06037191120,6037191120,2019,377,337,89.389999,330,7
1400000US06037191204,6037191204,2019,472,437,92.580002,428,9
1400000US06037191301,6037191301,2019,127,106,83.459999,100,6
1400000US06037191410,6037191410,2019,399,381,95.489998,359,22
1400000US06037191720,6037191720,2019,875,843,96.339996,786,57
1400000US06037191810,6037191810,2019,408,363,88.970001,348,15
1400000US06037191901,6037191901,2019,742,623,83.959999,599,24
1400000US06037192001,6037192001,2019,443,214,48.310001,179,35
1400000US06037192002,6037192002,2019,1816,1451,79.900002,1248,203
1400000US06037192410,6037192410,2019,198,170,85.860001,159,11
1400000US06037192520,6037192520,2019,380,336,88.419998,327,9
1400000US06037192620,6037192620,2019,659,606,91.959999,578,28
1400000US06037192700,6037192700,2019,400,348,87,334,14
1400000US06037194300,6037194300,2019,507,60,11.83,49,11
1400000US06037195201,6037195201,2019,2826,1849,65.43,1526,323
1400000US06037195300,6037195300,2019,2055,1521,74.010002,1259,262
1400000US06037195400,6037195400,2019,383,190,49.610001,157,33
1400000US06037195500,6037195500,2019,255,225,88.239998,204,21
1400000US06037195710,6037195710,2019,886,800,90.290001,756,44
1400000US06037197200,6037197200,2019,290,247,85.169998,211,36
1400000US06037197300,6037197300,2019,307,196,63.84,184,12
1400000US06037197410,6037197410,2019,141,98,69.5,84,14
1400000US06037197420,6037197420,2019,825,722,87.519997,653,69
1400000US06037199001,6037199001,2019,75,49,65.330002,43,6
1400000US06037199002,6037199002,2019,293,270,92.150002,261,9
1400000US06037199120,6037199120,2019,350,300,85.709999,261,39
1400000US06037199201,6037199201,2019,349,290,83.089996,259,31
1400000US06037199202,6037199202,2019,1227,1145,93.32,1094,51
1400000US06037199300,6037199300,2019,651,551,84.639999,512,39
1400000US06037199400,6037199400,2019,121,110,90.910004,108,2
1400000US06037199700,6037199700,2019,1568,1353,86.290001,1277,76
1400000US06037199801,6037199801,2019,393,360,91.599998,337,23
1400000US06037199802,6037199802,2019,599,529,88.309998,511,18
1400000US06037201120,6037201120,2019,204,160,78.43,144,16
1400000US06037201200,6037201200,2019,335,269,80.300003,263,6
1400000US06037201301,6037201301,2019,294,260,88.440002,254,6
1400000US06037201401,6037201401,2019,1526,1336,87.550003,1243,93
1400000US06037201402,6037201402,2019,1790,1536,85.809998,1386,150
1400000US06037201501,6037201501,2019,281,251,89.32,240,11
1400000US06037201602,6037201602,2019,342,289,84.5,268,21
1400000US06037201700,6037201700,2019,534,96,17.98,85,11
1400000US06037203100,6037203100,2019,430,407,94.650002,400,7
1400000US06037203200,6037203200,2019,655,629,96.029999,601,28
1400000US06037203300,6037203300,2019,1996,1724,86.370003,1567,157
1400000US06037203500,6037203500,2019,178,168,94.379997,160,8
1400000US06037203601,6037203601,2019,704,667,94.739998,641,26
1400000US06037203800,6037203800,2019,534,501,93.82,481,20
1400000US06037204110,6037204110,2019,448,404,90.18,340,64
1400000US06037204300,6037204300,2019,2289,2003,87.510002,1917,86
1400000US06037204410,6037204410,2019,297,272,91.580002,263,9
1400000US06037204420,6037204420,2019,810,783,96.669998,764,19
1400000US06037204700,6037204700,2019,2399,2155,89.830002,2030,125
1400000US06037204810,6037204810,2019,1520,1410,92.760002,1351,59
1400000US06037204820,6037204820,2019,597,574,96.150002,517,57
1400000US06037204910,6037204910,2019,1306,1224,93.720001,1140,84
1400000US06037205110,6037205110,2019,1064,941,88.440002,868,73
1400000US06037205120,6037205120,2019,98,92,93.879997,91,1
1400000US06037206010,6037206010,2019,332,215,64.760002,197,18
1400000US06037206050,6037206050,2019,106,87,82.080002,73,14
1400000US06037206051,6037206051,2019,433,385,88.910004,353,32
1400000US06037206054,6037206054,2019,1403,1297,92.440002,1227,70
1400000US06037207101,6037207101,2019,1199,856,71.389999,771,85
1400000US06037207103,6037207103,2019,638,385,60.34,377,8
1400000US06037207400,6037207400,2019,351,331,94.300003,310,21
1400000US06037207502,6037207502,2019,188,150,79.790001,138,12
1400000US06037208001,6037208001,2019,2715,2416,88.989998,2261,155
1400000US06037208002,6037208002,2019,543,490,90.239998,466,24
1400000US06037208302,6037208302,2019,1501,1402,93.400002,1355,47
1400000US06037208401,6037208401,2019,1045,1012,96.839996,997,15
1400000US06037208501,6037208501,2019,881,473,53.689999,413,60
1400000US06037208610,6037208610,2019,476,462,97.059998,441,21
1400000US06037208710,6037208710,2019,69,62,89.860001,59,3
1400000US06037208720,6037208720,2019,286,255,89.160004,229,26
1400000US06037208801,6037208801,2019,495,467,94.339996,461,6
1400000US06037208802,6037208802,2019,519,494,95.18,486,8
1400000US06037208902,6037208902,2019,1335,1314,98.43,1309,5
1400000US06037209103,6037209103,2019,780,704,90.260002,697,7
1400000US06037209104,6037209104,2019,393,393,100,392,1
1400000US06037209106,6037209106,2019,946,918,97.040001,912,6
1400000US06037209202,6037209202,2019,1147,1081,94.25,1058,23
1400000US06037209520,6037209520,2019,403,374,92.800003,342,32
1400000US06037209820,6037209820,2019,457,419,91.68,366,53
1400000US06037210010,6037210010,2019,716,689,96.230003,674,15
1400000US06037211000,6037211000,2019,1706,1332,78.080002,1162,170
1400000US06037211121,6037211121,2019,1044,938,89.849998,885,53
1400000US06037211122,6037211122,2019,2250,2118,94.129997,1965,153
1400000US06037211123,6037211123,2019,864,828,95.830002,814,14
1400000US06037211124,6037211124,2019,705,666,94.470001,620,46
1400000US06037211202,6037211202,2019,673,640,95.099998,624,16
1400000US06037211410,6037211410,2019,633,533,84.199997,465,68
1400000US06037211420,6037211420,2019,447,358,80.089996,318,40
1400000US06037212202,6037212202,2019,678,642,94.690002,632,10
1400000US06037212204,6037212204,2019,787,730,92.760002,659,71
1400000US06037212303,6037212303,2019,243,213,87.650002,187,26
1400000US06037212304,6037212304,2019,3720,3455,92.879997,3329,126
1400000US06037212610,6037212610,2019,888,785,88.400002,694,91
1400000US06037212800,6037212800,2019,2024,1477,72.970001,1366,111
1400000US06037213201,6037213201,2019,612,567,92.650002,548,19
1400000US06037213202,6037213202,2019,693,652,94.080002,635,17
1400000US06037213310,6037213310,2019,137,115,83.940002,113,2
1400000US06037213320,6037213320,2019,1154,1091,94.540001,1057,34
1400000US06037213402,6037213402,2019,667,638,95.650002,626,12
1400000US06037214100,6037214100,2019,601,160,26.620001,137,23
1400000US06037214501,6037214501,2019,695,225,32.369999,198,27
1400000US06037216201,6037216201,2019,124,106,85.480003,101,5
1400000US06037216301,6037216301,2019,322,202,62.73,175,27
1400000US06037216700,6037216700,2019,1999,1213,60.68,1000,213
1400000US06037217101,6037217101,2019,302,271,89.739998,257,14
1400000US06037218110,6037218110,2019,2033,1455,71.57,1365,90
1400000US06037218210,6037218210,2019,427,414,96.959999,393,21
1400000US06037218300,6037218300,2019,311,293,94.209999,264,29
1400000US06037218800,6037218800,2019,548,534,97.449997,518,16
1400000US06037218900,6037218900,2019,764,673,88.089996,597,76
1400000US06037219010,6037219010,2019,500,454,90.800003,450,4
1400000US06037219300,6037219300,2019,615,551,89.589996,504,47
1400000US06037219700,6037219700,2019,879,674,76.68,647,27
1400000US06037219800,6037219800,2019,576,524,90.970001,501,23
1400000US06037219902,6037219902,2019,718,636,88.580002,605,31
1400000US06037220000,6037220000,2019,283,265,93.639999,253,12
1400000US06037220100,6037220100,2019,938,538,57.360001,475,63
1400000US06037221120,6037221120,2019,825,778,94.300003,757,21
1400000US06037221304,6037221304,2019,650,565,86.919998,548,17
1400000US06037221401,6037221401,2019,1035,976,94.300003,930,46
1400000US06037221602,6037221602,2019,2129,2038,95.730003,1989,49
1400000US06037221810,6037221810,2019,535,498,93.080002,482,16
1400000US06037221900,6037221900,2019,353,339,96.029999,329,10
1400000US06037222002,6037222002,2019,532,464,87.220001,448,16
1400000US06037222500,6037222500,2019,1827,1725,94.419998,1615,110
1400000US06037222600,6037222600,2019,619,583,94.18,559,24
1400000US06037224010,6037224010,2019,33,27,81.82,27,0
1400000US06037224020,6037224020,2019,1792,1653,92.239998,1569,84
1400000US06037224320,6037224320,2019,454,425,93.610001,394,31
1400000US06037224410,6037224410,2019,1855,1744,94.019997,1607,137
1400000US06037224420,6037224420,2019,869,795,91.480003,761,34
1400000US06037224600,6037224600,2019,1291,1232,95.43,1201,31
1400000US06037224702,6037224702,2019,1028,920,89.489998,778,142
1400000US06037226001,6037226001,2019,3022,2875,95.139999,2787,88
1400000US06037226002,6037226002,2019,1134,971,85.629997,957,14
1400000US06037226702,6037226702,2019,1279,1240,96.949997,1196,44
1400000US06037227020,6037227020,2019,1258,1219,96.900002,1190,29
1400000US06037228100,6037228100,2019,1721,1676,97.389999,1604,72
1400000US06037228210,6037228210,2019,1635,1545,94.5,1482,63
1400000US06037228310,6037228310,2019,1236,1180,95.470001,1149,31
1400000US06037228320,6037228320,2019,570,538,94.389999,519,19
1400000US06037228410,6037228410,2019,637,602,94.510002,579,23
1400000US06037228420,6037228420,2019,1280,1228,95.940002,1122,106
1400000US06037228500,6037228500,2019,548,529,96.529999,501,28
1400000US06037228600,6037228600,2019,1245,1193,95.82,1165,28
1400000US06037228710,6037228710,2019,1152,1105,95.919998,1074,31
1400000US06037228720,6037228720,2019,808,774,95.790001,755,19
1400000US06037228800,6037228800,2019,218,211,96.790001,209,2
1400000US06037229200,6037229200,2019,644,625,97.050003,607,18
1400000US06037229300,6037229300,2019,453,444,98.010002,426,18
1400000US06037229410,6037229410,2019,2814,2713,96.410004,2647,66
1400000US06037229420,6037229420,2019,1820,1736,95.379997,1694,42
1400000US06037231100,6037231100,2019,1901,1847,97.160004,1745,102
1400000US06037231220,6037231220,2019,1152,978,84.900002,868,110
1400000US06037231302,6037231302,2019,396,371,93.690002,358,13
1400000US06037231400,6037231400,2019,104,98,94.230003,97,1
1400000US06037231500,6037231500,2019,384,352,91.669998,314,38
1400000US06037231603,6037231603,2019,1235,1123,90.93,1094,29
1400000US06037231710,6037231710,2019,471,462,98.089996,457,5
1400000US06037231720,6037231720,2019,237,217,91.559998,199,18
1400000US06037231800,6037231800,2019,693,668,96.389999,653,15
1400000US06037232110,6037232110,2019,1240,1175,94.760002,1152,23
1400000US06037232200,6037232200,2019,1439,1334,92.699997,1268,66
1400000US06037232300,6037232300,2019,258,185,71.709999,183,2
1400000US06037232401,6037232401,2019,687,619,90.099998,606,13
1400000US06037232402,6037232402,2019,274,264,96.349998,253,11
1400000US06037232500,6037232500,2019,467,423,90.580002,413,10
1400000US06037234001,6037234001,2019,722,684,94.739998,661,23
1400000US06037234002,6037234002,2019,408,384,94.120003,361,23
1400000US06037234301,6037234301,2019,654,605,92.510002,586,19
1400000US06037234501,6037234501,2019,1072,907,84.610001,863,44
1400000US06037234502,6037234502,2019,586,491,83.790001,464,27
1400000US06037234600,6037234600,2019,2341,1973,84.279999,1846,127
1400000US06037234700,6037234700,2019,273,262,95.970001,254,8
1400000US06037234901,6037234901,2019,498,478,95.980003,472,6
1400000US06037234902,6037234902,2019,159,141,88.68,131,10
1400000US06037235201,6037235201,2019,1298,1152,88.75,1087,65
1400000US06037236203,6037236203,2019,664,626,94.279999,587,39
1400000US06037236204,6037236204,2019,575,527,91.650002,523,4
1400000US06037236400,6037236400,2019,197,191,96.949997,181,10
1400000US06037237101,6037237101,2019,2795,2591,92.699997,2531,60
1400000US06037237102,6037237102,2019,557,531,95.330002,517,14
1400000US06037237300,6037237300,2019,432,333,77.080002,333,0
1400000US06037237500,6037237500,2019,599,572,95.489998,550,22
1400000US06037237600,6037237600,2019,706,674,95.470001,664,10
1400000US06037237800,6037237800,2019,509,491,96.459999,467,24
1400000US06037237900,6037237900,2019,449,390,86.860001,375,15
1400000US06037238000,6037238000,2019,763,711,93.18,680,31
1400000US06037238100,6037238100,2019,73,70,95.889999,60,10
1400000US06037238200,6037238200,2019,539,515,95.550003,480,35
1400000US06037238320,6037238320,2019,1175,1072,91.230003,999,73
1400000US06037238400,6037238400,2019,350,334,95.43,326,8
1400000US06037239201,6037239201,2019,1082,1063,98.239998,1053,10
1400000US06037239320,6037239320,2019,976,923,94.57,898,25
1400000US06037239330,6037239330,2019,791,749,94.690002,734,15
1400000US06037239502,6037239502,2019,3333,3203,96.099998,3127,76
1400000US06037239601,6037239601,2019,970,938,96.699997,919,19
1400000US06037239802,6037239802,2019,959,924,96.349998,902,22
1400000US06037240010,6037240010,2019,1104,1029,93.209999,1003,26
1400000US06037240020,6037240020,2019,429,396,92.309998,357,39
1400000US06037240200,6037240200,2019,753,730,96.949997,719,11
1400000US06037240301,6037240301,2019,763,737,96.589996,728,9
1400000US06037240302,6037240302,2019,187,178,95.190002,174,4
1400000US06037240401,6037240401,2019,1209,1138,94.129997,1115,23
1400000US06037240500,6037240500,2019,1441,1396,96.879997,1320,76
1400000US06037240600,6037240600,2019,1000,967,96.699997,947,20
1400000US06037240700,6037240700,2019,558,520,93.190002,505,15
1400000US06037240902,6037240902,2019,2106,2035,96.629997,1944,91
1400000US06037241001,6037241001,2019,907,870,95.919998,837,33
1400000US06037241110,6037241110,2019,917,863,94.110001,845,18
1400000US06037241120,6037241120,2019,428,411,96.029999,405,6
1400000US06037241202,6037241202,2019,577,539,93.410004,530,9
1400000US06037241400,6037241400,2019,567,541,95.410004,521,20
1400000US06037242000,6037242000,2019,365,346,94.790001,341,5
1400000US06037242100,6037242100,2019,931,877,94.199997,854,23
1400000US06037242201,6037242201,2019,794,763,96.099998,747,16
1400000US06037242202,6037242202,2019,797,752,94.349998,723,29
1400000US06037242300,6037242300,2019,689,663,96.230003,645,18
1400000US06037242600,6037242600,2019,626,616,98.400002,603,13
1400000US06037242700,6037242700,2019,1257,1231,97.93,1214,17
1400000US06037243001,6037243001,2019,498,481,96.589996,458,23
1400000US06037243002,6037243002,2019,441,433,98.190002,428,5
1400000US06037243100,6037243100,2019,481,468,97.300003,463,5
1400000US06037262200,6037262200,2019,901,165,18.309999,135,30
1400000US06037262303,6037262303,2019,550,42,7.6399999,39,3
1400000US06037262604,6037262604,2019,505,64,12.67,64,0
1400000US06037262704,6037262704,2019,2896,930,32.110001,801,129
1400000US06037262706,6037262706,2019,496,41,8.2700005,36,5
1400000US06037262802,6037262802,2019,2521,539,21.379999,483,56
1400000US06037264305,6037264305,2019,458,389,84.93,349,40
1400000US06037265100,6037265100,2019,650,49,7.54,45,4
1400000US06037265601,6037265601,2019,1007,391,38.830002,319,72
1400000US06037267202,6037267202,2019,800,76,9.5,65,11
1400000US06037267300,6037267300,2019,242,178,73.550003,157,21
1400000US06037267404,6037267404,2019,1467,1082,73.760002,900,182
1400000US06037267406,6037267406,2019,221,173,78.279999,155,18
1400000US06037267600,6037267600,2019,881,310,35.189999,267,43
1400000US06037269000,6037269000,2019,564,177,31.379999,162,15
1400000US06037269100,6037269100,2019,393,110,27.99,101,9
1400000US06037269300,6037269300,2019,482,40,8.3000002,36,4
1400000US06037269700,6037269700,2019,3026,2081,68.769997,1823,258
1400000US06037269907,6037269907,2019,303,238,78.550003,211,27
1400000US06037271200,6037271200,2019,643,200,31.1,171,29
1400000US06037271300,6037271300,2019,978,683,69.839996,624,59
1400000US06037271400,6037271400,2019,245,104,42.450001,94,10
1400000US06037271500,6037271500,2019,564,69,12.23,64,5
1400000US06037271702,6037271702,2019,553,147,26.58,132,15
1400000US06037271703,6037271703,2019,1256,721,57.400002,632,89
1400000US06037271801,6037271801,2019,285,234,82.110001,206,28
1400000US06037272100,6037272100,2019,1068,656,61.419998,597,59
1400000US06037272302,6037272302,2019,22,14,63.639999,12,2
1400000US06037273200,6037273200,2019,1199,639,53.290001,566,73
1400000US06037273403,6037273403,2019,404,290,71.779999,276,14
1400000US06037273800,6037273800,2019,2532,1356,53.549999,1206,150
1400000US06037274202,6037274202,2019,396,307,77.529999,285,22
1400000US06037275200,6037275200,2019,543,529,97.419998,478,51
1400000US06037275311,6037275311,2019,1475,655,44.41,622,33
1400000US06037275400,6037275400,2019,297,175,58.919998,152,23
1400000US06037275500,6037275500,2019,728,491,67.449997,463,28
1400000US06037275603,6037275603,2019,278,118,42.450001,94,24
1400000US06037275604,6037275604,2019,570,88,15.44,75,13
1400000US06037275605,6037275605,2019,426,357,83.800003,297,60
1400000US06037276000,6037276000,2019,261,147,56.32,123,24
1400000US06037276400,6037276400,2019,333,98,29.43,77,21
1400000US06037276605,6037276605,2019,387,254,65.629997,207,47
1400000US06037276607,6037276607,2019,351,252,71.790001,204,48
1400000US06037276608,6037276608,2019,1168,774,66.269997,669,105
1400000US06037277000,6037277000,2019,1726,846,49.02,691,155
1400000US06037277100,6037277100,2019,405,63,15.56,49,14
1400000US06037291120,6037291120,2019,696,624,89.660004,591,33
1400000US06037291210,6037291210,2019,510,455,89.220001,422,33
1400000US06037291220,6037291220,2019,346,304,87.860001,268,36
1400000US06037291300,6037291300,2019,947,721,76.139999,669,52
1400000US06037293204,6037293204,2019,485,425,87.629997,390,35
1400000US06037293302,6037293302,2019,2923,2253,77.080002,1964,289
1400000US06037293304,6037293304,2019,525,465,88.57,438,27
1400000US06037294110,6037294110,2019,2956,2618,88.57,2393,225
1400000US06037294200,6037294200,2019,1676,1413,84.309998,1353,60
1400000US06037294302,6037294302,2019,462,287,62.119999,204,83
1400000US06037294410,6037294410,2019,316,273,86.389999,269,4
1400000US06037294510,6037294510,2019,739,646,87.419998,626,20
1400000US06037294520,6037294520,2019,460,430,93.480003,405,25
1400000US06037294610,6037294610,2019,1188,1007,84.760002,943,64
1400000US06037294620,6037294620,2019,729,671,92.040001,599,72
1400000US06037294830,6037294830,2019,539,479,88.870003,468,11
1400000US06037294900,6037294900,2019,589,541,91.849998,520,21
1400000US06037295103,6037295103,2019,841,485,57.669998,389,96
1400000US06037296220,6037296220,2019,942,581,61.68,479,102
1400000US06037296300,6037296300,2019,688,396,57.560001,312,84
1400000US06037296401,6037296401,2019,399,257,64.410004,222,35
1400000US06037296500,6037296500,2019,845,742,87.809998,720,22
1400000US06037296600,6037296600,2019,358,318,88.830002,310,8
1400000US06037296901,6037296901,2019,3933,2633,66.949997,2253,380
1400000US06037297110,6037297110,2019,287,230,80.139999,200,30
1400000US06037297120,6037297120,2019,485,437,90.099998,413,24
1400000US06037297202,6037297202,2019,461,366,79.389999,324,42
1400000US06037297400,6037297400,2019,472,220,46.610001,166,54
1400000US06037297501,6037297501,2019,364,138,37.91,110,28
1400000US06037297601,6037297601,2019,64,51,79.690002,44,7
1400000US06037297602,6037297602,2019,329,220,66.870003,188,32
1400000US06037300200,6037300200,2019,2572,564,21.93,449,115
1400000US06037300301,6037300301,2019,2229,865,38.810001,694,171
1400000US06037300400,6037300400,2019,490,135,27.549999,98,37
1400000US06037300501,6037300501,2019,3035,853,28.110001,675,178
1400000US06037300602,6037300602,2019,681,166,24.379999,125,41
1400000US06037300800,6037300800,2019,774,251,32.43,208,43
1400000US06037300902,6037300902,2019,516,197,38.18,167,30
1400000US06037301000,6037301000,2019,1276,804,63.009998,702,102
1400000US06037301206,6037301206,2019,3780,2190,57.939999,1776,414
1400000US06037301400,6037301400,2019,850,538,63.290001,460,78
1400000US06037301502,6037301502,2019,647,499,77.129997,414,85
1400000US06037301602,6037301602,2019,656,110,16.77,87,23
1400000US06037301801,6037301801,2019,519,400,77.07,338,62
1400000US06037301902,6037301902,2019,950,654,68.839996,556,98
1400000US06037302002,6037302002,2019,124,95,76.610001,79,16
1400000US06037302004,6037302004,2019,482,413,85.68,355,58
1400000US06037302104,6037302104,2019,2127,1549,72.830002,1349,200
1400000US06037302302,6037302302,2019,916,556,60.700001,456,100
1400000US06037302504,6037302504,2019,2240,1868,83.389999,1664,204
1400000US06037302505,6037302505,2019,438,365,83.330002,324,41
1400000US06037310201,6037310201,2019,611,221,36.169998,195,26
1400000US06037310300,6037310300,2019,2195,751,34.209999,625,126
1400000US06037310601,6037310601,2019,443,249,56.209999,216,33
1400000US06037310602,6037310602,2019,2525,1064,42.139999,929,135
1400000US06037310703,6037310703,2019,744,353,47.450001,317,36
1400000US06037310705,6037310705,2019,23,17,73.910004,15,2
1400000US06037310800,6037310800,2019,2934,966,32.919998,827,139
1400000US06037310900,6037310900,2019,694,211,30.4,179,32
1400000US06037311000,6037311000,2019,951,389,40.900002,322,67
1400000US06037311100,6037311100,2019,949,396,41.73,319,77
1400000US06037311200,6037311200,2019,86,23,26.74,22,1
1400000US06037311500,6037311500,2019,1247,228,18.280001,194,34
1400000US06037311700,6037311700,2019,1056,370,35.040001,314,56
1400000US06037311802,6037311802,2019,477,202,42.349998,173,29
1400000US06037320101,6037320101,2019,495,408,82.419998,372,36
1400000US06037320102,6037320102,2019,1689,1489,88.160004,1354,135
1400000US06037320201,6037320201,2019,1501,1239,82.540001,1165,74
1400000US06037320202,6037320202,2019,511,459,89.82,399,60
1400000US06037320300,6037320300,2019,1867,1571,84.150002,1430,141
1400000US06037400205,6037400205,2019,36,36,100,36,0
1400000US06037400208,6037400208,2019,588,105,17.860001,94,11
1400000US06037400304,6037400304,2019,927,475,51.240002,410,65
1400000US06037400402,6037400402,2019,2271,591,26.02,519,72
1400000US06037400403,6037400403,2019,32,32,100,32,0
1400000US06037400404,6037400404,2019,623,109,17.5,95,14
1400000US06037400501,6037400501,2019,897,171,19.059999,140,31
1400000US06037400602,6037400602,2019,553,373,67.449997,324,49
1400000US06037400605,6037400605,2019,279,233,83.510002,207,26
1400000US06037400801,6037400801,2019,2040,861,42.209999,735,126
1400000US06037401001,6037401001,2019,590,136,23.049999,120,16
1400000US06037401202,6037401202,2019,860,396,46.049999,320,76
1400000US06037401203,6037401203,2019,98,51,52.040001,50,1
1400000US06037401311,6037401311,2019,1172,344,29.35,282,62
1400000US06037401312,6037401312,2019,2255,916,40.619999,736,180
1400000US06037401601,6037401601,2019,519,135,26.01,119,16
1400000US06037401602,6037401602,2019,2594,987,38.049999,810,177
1400000US06037401705,6037401705,2019,523,257,49.139999,243,14
1400000US06037401707,6037401707,2019,358,317,88.550003,289,28
1400000US06037401801,6037401801,2019,641,142,22.15,130,12
1400000US06037401802,6037401802,2019,2968,914,30.799999,792,122
1400000US06037401902,6037401902,2019,2008,722,35.959999,619,103
1400000US06037402001,6037402001,2019,328,203,61.889999,173,30
1400000US06037402002,6037402002,2019,346,180,52.02,156,24
1400000US06037402101,6037402101,2019,311,302,97.110001,273,29
1400000US06037402102,6037402102,2019,2070,1855,89.610001,1664,191
1400000US06037402200,6037402200,2019,314,270,85.989998,235,35
1400000US06037402301,6037402301,2019,1256,1145,91.160004,1018,127
1400000US06037402303,6037402303,2019,362,351,96.959999,319,32
1400000US06037402403,6037402403,2019,857,458,53.439999,385,73
1400000US06037402405,6037402405,2019,898,875,97.440002,783,92
1400000US06037402406,6037402406,2019,1042,1002,96.160004,932,70
1400000US06037402501,6037402501,2019,1159,1133,97.760002,1068,65
1400000US06037402503,6037402503,2019,887,858,96.730003,782,76
1400000US06037402504,6037402504,2019,490,455,92.860001,423,32
1400000US06037402601,6037402601,2019,603,579,96.019997,540,39
1400000US06037402702,6037402702,2019,1069,953,89.150002,874,79
1400000US06037402703,6037402703,2019,307,283,92.18,242,41
1400000US06037402705,6037402705,2019,555,510,91.889999,467,43
1400000US06037402706,6037402706,2019,246,222,90.239998,199,23
1400000US06037402902,6037402902,2019,626,589,94.089996,541,48
1400000US06037402903,6037402903,2019,1608,1517,94.339996,1399,118
1400000US06037403000,6037403000,2019,3064,2930,95.629997,2634,296
1400000US06037403316,6037403316,2019,948,729,76.900002,578,151
1400000US06037403317,6037403317,2019,1966,1391,70.75,1029,362
1400000US06037403318,6037403318,2019,529,400,75.610001,303,97
1400000US06037403320,6037403320,2019,406,261,64.290001,196,65
1400000US06037403321,6037403321,2019,307,236,76.870003,178,58
1400000US06037403323,6037403323,2019,1759,365,20.75,329,36
1400000US06037403324,6037403324,2019,657,132,20.09,120,12
1400000US06037403325,6037403325,2019,3938,803,20.389999,737,66
1400000US06037403326,6037403326,2019,659,168,25.49,141,27
1400000US06037403327,6037403327,2019,292,209,71.580002,160,49
1400000US06037403401,6037403401,2019,477,150,31.450001,132,18
1400000US06037403402,6037403402,2019,2898,692,23.879999,625,67
1400000US06037403404,6037403404,2019,1237,292,23.610001,248,44
1400000US06037403407,6037403407,2019,581,91,15.66,82,9
1400000US06037403408,6037403408,2019,1040,507,48.75,410,97
1400000US06037403409,6037403409,2019,568,148,26.059999,129,19
1400000US06037403601,6037403601,2019,862,558,64.730003,453,105
1400000US06037403702,6037403702,2019,1858,992,53.389999,856,136
1400000US06037403703,6037403703,2019,388,253,65.209999,225,28
1400000US06037403722,6037403722,2019,696,386,55.459999,338,48
1400000US06037403801,6037403801,2019,1099,723,65.790001,645,78
1400000US06037403901,6037403901,2019,57,31,54.389999,28,3
1400000US06037403902,6037403902,2019,416,224,53.849998,201,23
1400000US06037404000,6037404000,2019,772,670,86.790001,570,100
1400000US06037404100,6037404100,2019,452,405,89.599998,361,44
1400000US06037404201,6037404201,2019,2014,1685,83.660004,1469,216
1400000US06037404203,6037404203,2019,227,173,76.209999,156,17
1400000US06037404401,6037404401,2019,638,515,80.720001,429,86
1400000US06037404402,6037404402,2019,684,568,83.040001,496,72
1400000US06037404503,6037404503,2019,274,248,90.510002,232,16
1400000US06037404504,6037404504,2019,429,401,93.470001,370,31
1400000US06037404600,6037404600,2019,2950,1974,66.919998,1800,174
1400000US06037404701,6037404701,2019,808,808,100,808,0
1400000US06037404702,6037404702,2019,650,650,100,650,0
1400000US06037404804,6037404804,2019,2642,2642,100,2642,0
1400000US06037404805,6037404805,2019,472,472,100,472,0
1400000US06037404806,6037404806,2019,1028,1028,100,1028,0
1400000US06037404901,6037404901,2019,542,454,83.760002,403,51
1400000US06037404903,6037404903,2019,445,445,100,445,0
1400000US06037405001,6037405001,2019,923,843,91.330002,825,18
1400000US06037405002,6037405002,2019,345,345,100,345,0
1400000US06037405101,6037405101,2019,1572,1506,95.800003,1465,41
1400000US06037405201,6037405201,2019,2181,2181,100,2181,0
1400000US06037405202,6037405202,2019,628,542,86.309998,494,48
1400000US06037405302,6037405302,2019,500,392,78.400002,333,59
1400000US06037405400,6037405400,2019,351,253,72.080002,213,40
1400000US06037405600,6037405600,2019,1035,739,71.400002,606,133
1400000US06037405701,6037405701,2019,861,688,79.910004,591,97
1400000US06037405702,6037405702,2019,1230,912,74.150002,733,179
1400000US06037405800,6037405800,2019,1623,1275,78.559998,1120,155
1400000US06037406000,6037406000,2019,1855,1337,72.080002,1090,247
1400000US06037406103,6037406103,2019,620,431,69.519997,357,74
1400000US06037406201,6037406201,2019,1236,909,73.540001,745,164
1400000US06037406300,6037406300,2019,2299,1216,52.889999,971,245
1400000US06037406413,6037406413,2019,1332,864,64.860001,733,131
1400000US06037406601,6037406601,2019,3544,2529,71.360001,2162,367
1400000US06037406602,6037406602,2019,395,338,85.57,299,39
1400000US06037406701,6037406701,2019,309,259,83.82,213,46
1400000US06037406702,6037406702,2019,203,172,84.730003,146,26
1400000US06037406801,6037406801,2019,1928,1425,73.910004,1204,221
1400000US06037406903,6037406903,2019,2293,1577,68.769997,1316,261
1400000US06037407001,6037407001,2019,383,352,91.910004,330,22
1400000US06037407002,6037407002,2019,599,562,93.82,522,40
1400000US06037407101,6037407101,2019,1673,1529,91.389999,1387,142
1400000US06037407201,6037407201,2019,296,272,91.889999,232,40
1400000US06037407301,6037407301,2019,336,314,93.449997,290,24
1400000US06037407302,6037407302,2019,1146,1023,89.269997,863,160
1400000US06037407501,6037407501,2019,909,757,83.279999,590,167
1400000US06037407502,6037407502,2019,636,539,84.75,469,70
1400000US06037407602,6037407602,2019,607,545,89.790001,489,56
1400000US06037407701,6037407701,2019,495,487,98.379997,467,20
1400000US06037407702,6037407702,2019,1383,1236,89.370003,1069,167
1400000US06037407801,6037407801,2019,513,429,83.629997,361,68
1400000US06037407802,6037407802,2019,1303,1106,84.879997,946,160
1400000US06037407901,6037407901,2019,574,462,80.489998,397,65
1400000US06037408003,6037408003,2019,194,143,73.709999,133,10
1400000US06037408135,6037408135,2019,568,527,92.779999,491,36
1400000US06037408136,6037408136,2019,363,305,84.019997,276,29
1400000US06037408137,6037408137,2019,766,618,80.68,530,88
1400000US06037408138,6037408138,2019,411,398,96.839996,378,20
1400000US06037408139,6037408139,2019,451,422,93.57,384,38
1400000US06037408140,6037408140,2019,595,559,93.949997,519,40
1400000US06037408141,6037408141,2019,2319,2026,87.370003,1838,188
1400000US06037408212,6037408212,2019,688,405,58.869999,353,52
1400000US06037408213,6037408213,2019,362,306,84.529999,278,28
1400000US06037408301,6037408301,2019,457,440,96.279999,416,24
1400000US06037408302,6037408302,2019,641,420,65.519997,352,68
1400000US06037408401,6037408401,2019,15,7,46.669998,4,3
1400000US06037408402,6037408402,2019,948,787,83.019997,647,140
1400000US06037408503,6037408503,2019,976,484,49.59,387,97
1400000US06037408504,6037408504,2019,581,354,60.93,282,72
1400000US06037408505,6037408505,2019,1958,1385,70.739998,1083,302
1400000US06037408623,6037408623,2019,2021,1116,55.220001,891,225
1400000US06037408624,6037408624,2019,259,208,80.309998,175,33
1400000US06037408625,6037408625,2019,1696,764,45.049999,604,160
1400000US06037408631,6037408631,2019,577,433,75.040001,359,74
1400000US06037408705,6037408705,2019,2902,1865,64.269997,1585,280
1400000US06037408707,6037408707,2019,895,230,25.700001,211,19
1400000US06037408722,6037408722,2019,646,362,56.040001,308,54
1400000US06037408724,6037408724,2019,495,464,93.739998,440,24
1400000US06037408725,6037408725,2019,737,530,71.910004,448,82
1400000US06037408900,6037408900,2019,1806,741,41.029999,629,112
1400000US06037409000,6037409000,2019,533,499,93.620003,448,51
1400000US06037409100,6037409100,2019,189,165,87.300003,146,19
1400000US06037430003,6037430003,2019,341,188,55.130001,142,46
1400000US06037430005,6037430005,2019,404,326,80.690002,270,56
1400000US06037430101,6037430101,2019,1973,1070,54.23,840,230
1400000US06037430102,6037430102,2019,420,356,84.760002,298,58
1400000US06037430200,6037430200,2019,960,455,47.400002,308,147
1400000US06037430302,6037430302,2019,506,212,41.900002,177,35
1400000US06037430400,6037430400,2019,1423,262,18.41,226,36
1400000US06037430502,6037430502,2019,1244,253,20.34,215,38
1400000US06037430701,6037430701,2019,625,165,26.4,143,22
1400000US06037430721,6037430721,2019,3086,803,26.02,672,131
1400000US06037430801,6037430801,2019,892,239,26.790001,208,31
1400000US06037430802,6037430802,2019,1345,397,29.52,323,74
1400000US06037431002,6037431002,2019,583,358,61.41,330,28
1400000US06037431003,6037431003,2019,1574,782,49.68,668,114
1400000US06037431004,6037431004,2019,1703,1044,61.299999,898,146
1400000US06037431100,6037431100,2019,521,377,72.360001,333,44
1400000US06037431200,6037431200,2019,484,414,85.540001,355,59
1400000US06037431400,6037431400,2019,425,274,64.470001,239,35
1400000US06037431501,6037431501,2019,387,309,79.839996,267,42
1400000US06037431502,6037431502,2019,713,618,86.68,559,59
1400000US06037431600,6037431600,2019,474,136,28.690001,114,22
1400000US06037431701,6037431701,2019,1336,380,28.440001,327,53
1400000US06037431800,6037431800,2019,1928,759,39.369999,661,98
1400000US06037431900,6037431900,2019,991,369,37.240002,317,52
1400000US06037432002,6037432002,2019,490,206,42.040001,163,43
1400000US06037432102,6037432102,2019,560,227,40.540001,194,33
1400000US06037432201,6037432201,2019,491,371,75.559998,316,55
1400000US06037432202,6037432202,2019,2634,2151,81.660004,1817,334
1400000US06037432300,6037432300,2019,874,800,91.529999,737,63
1400000US06037432401,6037432401,2019,2782,2428,87.279999,2129,299
1400000US06037432402,6037432402,2019,508,482,94.879997,438,44
1400000US06037432501,6037432501,2019,360,329,91.389999,306,23
1400000US06037432602,6037432602,2019,1327,1249,94.120003,1141,108
1400000US06037432801,6037432801,2019,581,568,97.760002,543,25
1400000US06037432902,6037432902,2019,406,353,86.949997,301,52
1400000US06037433103,6037433103,2019,390,378,96.919998,350,28
1400000US06037433200,6037433200,2019,2850,2697,94.629997,2480,217
1400000US06037433302,6037433302,2019,788,752,95.43,705,47
1400000US06037433305,6037433305,2019,477,433,90.779999,410,23
1400000US06037433306,6037433306,2019,385,361,93.769997,339,22
1400000US06037433307,6037433307,2019,634,578,91.169998,536,42
1400000US06037433505,6037433505,2019,1214,1167,96.129997,1104,63
1400000US06037433803,6037433803,2019,1750,1536,87.769997,1371,165
1400000US06037433804,6037433804,2019,1030,890,86.410004,817,73
1400000US06037433901,6037433901,2019,456,426,93.419998,406,20
1400000US06037433903,6037433903,2019,1199,1130,94.25,1049,81
1400000US06037434001,6037434001,2019,1321,1230,93.110001,1115,115
1400000US06037434003,6037434003,2019,1211,1135,93.720001,1063,72
1400000US06037434100,6037434100,2019,535,434,81.120003,373,61
1400000US06037460002,6037460002,2019,554,221,39.889999,183,38
1400000US06037460101,6037460101,2019,417,79,18.940001,69,10
1400000US06037460200,6037460200,2019,198,141,71.209999,103,38
1400000US06037460301,6037460301,2019,490,178,36.330002,154,24
1400000US06037460302,6037460302,2019,651,286,43.93,250,36
1400000US06037460501,6037460501,2019,736,31,4.21,29,2
1400000US06037460502,6037460502,2019,620,21,3.3900001,19,2
1400000US06037460601,6037460601,2019,677,35,5.1700001,35,0
1400000US06037460700,6037460700,2019,2021,98,4.8499999,97,1
1400000US06037460900,6037460900,2019,1057,715,67.639999,668,47
1400000US06037461000,6037461000,2019,634,381,60.09,344,37
1400000US06037461100,6037461100,2019,225,151,67.110001,138,13
1400000US06037461200,6037461200,2019,513,374,72.900002,344,30
1400000US06037461300,6037461300,2019,345,226,65.510002,167,59
1400000US06037461400,6037461400,2019,420,323,76.900002,288,35
1400000US06037461502,6037461502,2019,948,783,82.589996,734,49
1400000US06037461700,6037461700,2019,281,226,80.43,218,8
1400000US06037462100,6037462100,2019,393,358,91.089996,342,16
1400000US06037462500,6037462500,2019,2193,1300,59.279999,1120,180
1400000US06037462600,6037462600,2019,1955,1144,58.52,969,175
1400000US06037462700,6037462700,2019,367,312,85.010002,276,36
1400000US06037462900,6037462900,2019,115,102,88.699997,96,6
1400000US06037463000,6037463000,2019,489,110,22.49,90,20
1400000US06037463200,6037463200,2019,1075,742,69.019997,636,106
1400000US06037463300,6037463300,2019,605,259,42.810001,213,46
1400000US06037463601,6037463601,2019,1102,706,64.07,625,81
1400000US06037463800,6037463800,2019,440,153,34.77,130,23
1400000US06037464000,6037464000,2019,946,515,54.439999,469,46
1400000US06037464101,6037464101,2019,1244,64,5.1399999,58,6
1400000US06037464200,6037464200,2019,1075,99,9.21,89,10
1400000US06037480002,6037480002,2019,867,143,16.49,112,31
1400000US06037480012,6037480012,2019,1580,626,39.619999,526,100
1400000US06037480201,6037480201,2019,343,146,42.57,123,23
1400000US06037480202,6037480202,2019,464,243,52.369999,186,57
1400000US06037480302,6037480302,2019,459,324,70.589996,282,42
1400000US06037480304,6037480304,2019,2840,1968,69.300003,1633,335
1400000US06037480400,6037480400,2019,1610,958,59.5,777,181
1400000US06037480500,6037480500,2019,1916,331,17.280001,299,32
1400000US06037480702,6037480702,2019,671,104,15.5,91,13
1400000US06037480703,6037480703,2019,683,108,15.81,96,12
1400000US06037480704,6037480704,2019,1422,284,19.969999,242,42
1400000US06037480803,6037480803,2019,435,287,65.980003,249,38
1400000US06037480804,6037480804,2019,732,461,62.98,384,77
1400000US06037480901,6037480901,2019,198,129,65.150002,124,5
1400000US06037480903,6037480903,2019,772,479,62.049999,415,64
1400000US06037481101,6037481101,2019,498,274,55.02,241,33
1400000US06037481102,6037481102,2019,41,36,87.800003,32,4
1400000US06037481103,6037481103,2019,1995,1519,76.139999,1382,137
1400000US06037481203,6037481203,2019,1493,996,66.709999,837,159
1400000US06037481300,6037481300,2019,577,447,77.470001,358,89
1400000US06037481401,6037481401,2019,608,434,71.379997,358,76
1400000US06037481403,6037481403,2019,385,330,85.709999,299,31
1400000US06037481404,6037481404,2019,1656,926,55.919998,755,171
1400000US06037481500,6037481500,2019,2239,1282,57.259998,1077,205
1400000US06037481606,6037481606,2019,808,565,69.93,475,90
1400000US06037481901,6037481901,2019,540,326,60.369999,241,85
1400000US06037482001,6037482001,2019,1018,452,44.400002,362,90
1400000US06037482002,6037482002,2019,927,353,38.080002,296,57
1400000US06037482101,6037482101,2019,800,575,71.879997,499,76
1400000US06037482102,6037482102,2019,814,415,50.98,323,92
1400000US06037482202,6037482202,2019,523,346,66.160004,305,41
1400000US06037482303,6037482303,2019,38,36,94.739998,33,3
1400000US06037482304,6037482304,2019,463,382,82.510002,354,28
1400000US06037482401,6037482401,2019,361,295,81.720001,280,15
1400000US06037482403,6037482403,2019,1210,1040,85.949997,957,83
1400000US06037482502,6037482502,2019,1160,914,78.790001,840,74
1400000US06037482522,6037482522,2019,387,244,63.049999,195,49
1400000US06037482600,6037482600,2019,382,241,63.09,214,27
1400000US06037482701,6037482701,2019,513,421,82.07,364,57
1400000US06037482801,6037482801,2019,795,599,75.349998,504,95
1400000US06037500202,6037500202,2019,3721,1971,52.970001,1522,449
1400000US06037500203,6037500203,2019,550,127,23.09,99,28
1400000US06037500300,6037500300,2019,438,300,68.489998,266,34
1400000US06037500402,6037500402,2019,673,517,76.82,460,57
1400000US06037500404,6037500404,2019,372,294,79.029999,249,45
1400000US06037500600,6037500600,2019,703,578,82.220001,496,82
1400000US06037500700,6037500700,2019,453,315,69.540001,262,53
1400000US06037500800,6037500800,2019,2795,1860,66.550003,1599,261
1400000US06037500900,6037500900,2019,520,407,78.269997,373,34
1400000US06037501001,6037501001,2019,356,304,85.389999,273,31
1400000US06037501002,6037501002,2019,1272,1044,82.080002,924,120
1400000US06037501200,6037501200,2019,377,289,76.660004,258,31
1400000US06037501302,6037501302,2019,1508,1191,78.980003,1051,140
1400000US06037501400,6037501400,2019,1853,1430,77.169998,1215,215
1400000US06037501600,6037501600,2019,401,291,72.57,262,29
1400000US06037501700,6037501700,2019,710,290,40.849998,231,59
1400000US06037501804,6037501804,2019,411,367,89.290001,334,33
1400000US06037502003,6037502003,2019,402,339,84.330002,294,45
1400000US06037502005,6037502005,2019,590,432,73.220001,347,85
1400000US06037502200,6037502200,2019,542,407,75.089996,355,52
1400000US06037502303,6037502303,2019,2370,2033,85.779999,1803,230
1400000US06037502401,6037502401,2019,1314,959,72.980003,781,178
1400000US06037502500,6037502500,2019,241,167,69.290001,138,29
1400000US06037502602,6037502602,2019,405,313,77.279999,270,43
1400000US06037502603,6037502603,2019,610,413,67.699997,322,91
1400000US06037502604,6037502604,2019,426,314,73.709999,255,59
1400000US06037502700,6037502700,2019,778,560,71.980003,464,96
1400000US06037502801,6037502801,2019,3520,2538,72.099998,1837,701
1400000US06037503103,6037503103,2019,457,418,91.470001,385,33
1400000US06037503105,6037503105,2019,570,497,87.190002,434,63
1400000US06037503201,6037503201,2019,387,272,70.279999,237,35
1400000US06037503202,6037503202,2019,362,312,86.190002,265,47
1400000US06037503302,6037503302,2019,3319,2439,73.489998,2021,418
1400000US06037503402,6037503402,2019,579,173,29.879999,141,32
1400000US06037503501,6037503501,2019,1049,674,64.25,558,116
1400000US06037503502,6037503502,2019,691,461,66.709999,404,57
1400000US06037503602,6037503602,2019,2487,1404,56.450001,1230,174
1400000US06037503701,6037503701,2019,1735,805,46.400002,645,160
1400000US06037503705,6037503705,2019,265,140,52.830002,126,14
1400000US06037503801,6037503801,2019,1096,604,55.110001,549,55
1400000US06037503802,6037503802,2019,423,240,56.740002,210,30
1400000US06037503902,6037503902,2019,556,250,44.959999,218,32
1400000US06037504002,6037504002,2019,1427,757,53.049999,671,86
1400000US06037504101,6037504101,2019,326,264,80.980003,246,18
1400000US06037504200,6037504200,2019,1841,1600,86.910004,1441,159
1400000US06037530005,6037530005,2019,2686,1969,73.309998,1704,265
1400000US06037530007,6037530007,2019,1873,1573,83.980003,1404,169
1400000US06037530101,6037530101,2019,359,325,90.529999,303,22
1400000US06037530102,6037530102,2019,4157,3551,85.419998,3241,310
1400000US06037530202,6037530202,2019,747,697,93.309998,658,39
1400000US06037530203,6037530203,2019,560,502,89.639999,460,42
1400000US06037530301,6037530301,2019,3534,3259,92.220001,3033,226
1400000US06037530400,6037530400,2019,1844,1628,88.290001,1394,234
1400000US06037530500,6037530500,2019,700,623,89,585,38
1400000US06037530603,6037530603,2019,657,518,78.839996,475,43
1400000US06037530700,6037530700,2019,597,511,85.589996,455,56
1400000US06037530801,6037530801,2019,388,359,92.529999,349,10
1400000US06037530902,6037530902,2019,645,594,92.089996,575,19
1400000US06037531000,6037531000,2019,2916,2690,92.25,2539,151
1400000US06037531101,6037531101,2019,3020,2564,84.900002,2434,130
1400000US06037531102,6037531102,2019,972,916,94.239998,878,38
1400000US06037531201,6037531201,2019,735,680,92.519997,653,27
1400000US06037531202,6037531202,2019,170,163,95.879997,159,4
1400000US06037531302,6037531302,2019,1201,1118,93.089996,1022,96
1400000US06037531502,6037531502,2019,932,864,92.699997,821,43
1400000US06037531503,6037531503,2019,583,547,93.830002,528,19
1400000US06037531603,6037531603,2019,1519,1408,92.690002,1310,98
1400000US06037531604,6037531604,2019,150,146,97.330002,142,4
1400000US06037531701,6037531701,2019,566,496,87.629997,419,77
1400000US06037531702,6037531702,2019,564,469,83.160004,452,17
1400000US06037531800,6037531800,2019,710,578,81.410004,552,26
1400000US06037531902,6037531902,2019,479,381,79.540001,358,23
1400000US06037532002,6037532002,2019,513,414,80.699997,371,43
1400000US06037532101,6037532101,2019,38,30,78.949997,30,0
1400000US06037532102,6037532102,2019,859,745,86.730003,709,36
1400000US06037532200,6037532200,2019,247,200,80.970001,193,7
1400000US06037532302,6037532302,2019,423,349,82.510002,325,24
1400000US06037532303,6037532303,2019,768,600,78.129997,512,88
1400000US06037532500,6037532500,2019,3083,2874,93.220001,2694,180
1400000US06037532605,6037532605,2019,347,342,98.559998,294,48
1400000US06037532607,6037532607,2019,2121,1969,92.830002,1847,122
1400000US06037532700,6037532700,2019,909,870,95.709999,832,38
1400000US06037532800,6037532800,2019,2677,2560,95.629997,2496,64
1400000US06037532900,6037532900,2019,1941,1862,95.93,1817,45
1400000US06037533103,6037533103,2019,2892,2710,93.709999,2542,168
1400000US06037533108,6037533108,2019,2504,2354,94.010002,2231,123
1400000US06037533201,6037533201,2019,534,485,90.82,448,37
1400000US06037533204,6037533204,2019,542,473,87.269997,448,25
1400000US06037533402,6037533402,2019,1383,1292,93.419998,1200,92
1400000US06037533403,6037533403,2019,1642,1494,90.989998,1379,115
1400000US06037533501,6037533501,2019,1431,1313,91.75,1224,89
1400000US06037533504,6037533504,2019,778,699,89.849998,633,66
1400000US06037533601,6037533601,2019,912,826,90.57,767,59
1400000US06037533602,6037533602,2019,2588,2288,88.410004,2106,182
1400000US06037533603,6037533603,2019,2332,2146,92.019997,1979,167
1400000US06037533701,6037533701,2019,1353,1232,91.059998,1125,107
1400000US06037533703,6037533703,2019,589,540,91.68,509,31
1400000US06037533804,6037533804,2019,665,591,88.870003,556,35
1400000US06037533901,6037533901,2019,3471,2876,82.860001,2638,238
1400000US06037533902,6037533902,2019,648,529,81.639999,510,19
1400000US06037534001,6037534001,2019,808,729,90.220001,672,57
1400000US06037534002,6037534002,2019,870,730,83.910004,677,53
1400000US06037534102,6037534102,2019,1155,1061,91.860001,992,69
1400000US06037534201,6037534201,2019,953,812,85.199997,762,50
1400000US06037534302,6037534302,2019,416,390,93.75,379,11
1400000US06037534404,6037534404,2019,1322,1226,92.739998,1161,65
1400000US06037534405,6037534405,2019,1691,1592,94.150002,1512,80
1400000US06037534406,6037534406,2019,1287,1169,90.830002,1113,56
1400000US06037534501,6037534501,2019,954,852,89.309998,767,85
1400000US06037534803,6037534803,2019,632,579,91.610001,538,41
1400000US06037534804,6037534804,2019,455,407,89.449997,373,34
1400000US06037534900,6037534900,2019,2590,2426,93.669998,2181,245
1400000US06037535001,6037535001,2019,1632,1544,94.610001,1514,30
1400000US06037535101,6037535101,2019,2656,2507,94.389999,2434,73
1400000US06037535102,6037535102,2019,696,667,95.830002,649,18
1400000US06037535300,6037535300,2019,1229,1131,92.029999,1083,48
1400000US06037535501,6037535501,2019,555,516,92.970001,487,29
1400000US06037535603,6037535603,2019,526,473,89.919998,432,41
1400000US06037535604,6037535604,2019,548,505,92.150002,485,20
1400000US06037535605,6037535605,2019,1130,1006,89.029999,891,115
1400000US06037535607,6037535607,2019,4010,3680,91.769997,3409,271
1400000US06037535701,6037535701,2019,654,599,91.589996,566,33
1400000US06037535702,6037535702,2019,3147,2775,88.18,2527,248
1400000US06037535803,6037535803,2019,383,355,92.690002,336,19
1400000US06037535901,6037535901,2019,1614,1374,85.129997,1212,162
1400000US06037536000,6037536000,2019,2587,2287,88.400002,2082,205
1400000US06037536103,6037536103,2019,602,530,88.040001,469,61
1400000US06037536104,6037536104,2019,1899,1478,77.830002,1353,125
1400000US06037536201,6037536201,2019,991,937,94.550003,808,129
1400000US06037540000,6037540000,2019,2614,2393,91.550003,2166,227
1400000US06037540101,6037540101,2019,3125,2768,88.580002,2456,312
1400000US06037540202,6037540202,2019,1949,1852,95.019997,1699,153
1400000US06037540203,6037540203,2019,575,541,94.089996,486,55
1400000US06037540300,6037540300,2019,446,433,97.089996,396,37
1400000US06037540400,6037540400,2019,346,330,95.379997,325,5
1400000US06037540502,6037540502,2019,691,656,94.93,613,43
1400000US06037540600,6037540600,2019,531,432,81.360001,425,7
1400000US06037540700,6037540700,2019,2371,2006,84.610001,1829,177
1400000US06037540800,6037540800,2019,1473,1362,92.459999,1287,75
1400000US06037540901,6037540901,2019,665,606,91.129997,578,28
1400000US06037540902,6037540902,2019,440,383,87.050003,355,28
1400000US06037541003,6037541003,2019,544,429,78.860001,366,63
1400000US06037541100,6037541100,2019,426,354,83.099998,343,11
1400000US06037541200,6037541200,2019,940,797,84.790001,764,33
1400000US06037541300,6037541300,2019,1327,1138,85.760002,1074,64
1400000US06037541401,6037541401,2019,534,420,78.650002,400,20
1400000US06037541500,6037541500,2019,831,700,84.239998,665,35
1400000US06037541603,6037541603,2019,924,852,92.209999,834,18
1400000US06037541605,6037541605,2019,599,464,77.459999,452,12
1400000US06037541700,6037541700,2019,3555,3359,94.489998,3069,290
1400000US06037541802,6037541802,2019,613,578,94.290001,507,71
1400000US06037542000,6037542000,2019,1435,1146,79.860001,1105,41
1400000US06037542104,6037542104,2019,582,492,84.540001,476,16
1400000US06037542106,6037542106,2019,2982,2523,84.610001,2403,120
1400000US06037542200,6037542200,2019,940,746,79.360001,723,23
1400000US06037542401,6037542401,2019,724,685,94.610001,623,62
1400000US06037542402,6037542402,2019,2510,2101,83.709999,1981,120
1400000US06037542601,6037542601,2019,593,463,78.080002,448,15
1400000US06037542700,6037542700,2019,1277,1035,81.050003,1002,33
1400000US06037542800,6037542800,2019,748,651,87.029999,622,29
1400000US06037542900,6037542900,2019,676,560,82.839996,512,48
1400000US06037543000,6037543000,2019,778,645,82.900002,607,38
1400000US06037543100,6037543100,2019,999,792,79.279999,750,42
1400000US06037543201,6037543201,2019,726,509,70.110001,499,10
1400000US06037543203,6037543203,2019,268,210,78.360001,205,5
1400000US06037543304,6037543304,2019,256,228,89.059998,193,35
1400000US06037543306,6037543306,2019,339,247,72.860001,222,25
1400000US06037543321,6037543321,2019,662,301,45.470001,262,39
1400000US06037543322,6037543322,2019,1456,1144,78.57,1044,100
1400000US06037543400,6037543400,2019,313,260,83.07,211,49
1400000US06037543501,6037543501,2019,1724,1309,75.93,1109,200
1400000US06037543503,6037543503,2019,991,873,88.089996,773,100
1400000US06037543601,6037543601,2019,909,674,74.150002,547,127
1400000US06037543607,6037543607,2019,397,265,66.75,204,61
1400000US06037543701,6037543701,2019,3065,2188,71.389999,1796,392
1400000US06037543705,6037543705,2019,480,397,82.709999,370,27
1400000US06037543801,6037543801,2019,672,510,75.889999,407,103
1400000US06037543903,6037543903,2019,1266,980,77.410004,820,160
1400000US06037544001,6037544001,2019,489,430,87.93,356,74
1400000US06037544002,6037544002,2019,847,651,76.860001,532,119
1400000US06037550101,6037550101,2019,325,254,78.150002,186,68
1400000US06037550201,6037550201,2019,262,181,69.080002,151,30
1400000US06037550202,6037550202,2019,381,273,71.650002,217,56
1400000US06037550301,6037550301,2019,449,293,65.260002,224,69
1400000US06037550501,6037550501,2019,684,482,70.470001,381,101
1400000US06037550602,6037550602,2019,736,435,59.099998,347,88
1400000US06037550700,6037550700,2019,2153,1433,66.559998,1089,344
1400000US06037550801,6037550801,2019,768,536,69.790001,445,91
1400000US06037550901,6037550901,2019,4051,2582,63.740002,1966,616
1400000US06037551001,6037551001,2019,787,449,57.049999,354,95
1400000US06037551002,6037551002,2019,1401,931,66.449997,719,212
1400000US06037551101,6037551101,2019,535,466,87.099998,400,66
1400000US06037551102,6037551102,2019,241,149,61.830002,131,18
1400000US06037551201,6037551201,2019,508,378,74.410004,305,73
1400000US06037551203,6037551203,2019,1156,901,77.940002,725,176
1400000US06037551204,6037551204,2019,613,471,76.839996,381,90
1400000US06037551300,6037551300,2019,3555,2387,67.139999,1799,588
1400000US06037551402,6037551402,2019,744,540,72.580002,420,120
1400000US06037551501,6037551501,2019,2109,1562,74.059998,1242,320
1400000US06037551700,6037551700,2019,437,342,78.260002,290,52
1400000US06037551801,6037551801,2019,569,364,63.970001,304,60
1400000US06037551802,6037551802,2019,835,613,73.410004,529,84
1400000US06037551900,6037551900,2019,354,315,88.980003,276,39
1400000US06037552001,6037552001,2019,385,347,90.129997,314,33
1400000US06037552100,6037552100,2019,3408,2874,84.330002,2528,346
1400000US06037552200,6037552200,2019,375,351,93.599998,320,31
1400000US06037552301,6037552301,2019,409,368,89.980003,339,29
1400000US06037552302,6037552302,2019,1202,1039,86.440002,937,102
1400000US06037552601,6037552601,2019,454,428,94.269997,389,39
1400000US06037552602,6037552602,2019,485,429,88.449997,379,50
1400000US06037552700,6037552700,2019,567,509,89.769997,471,38
1400000US06037552800,6037552800,2019,2029,1764,86.940002,1548,216
1400000US06037553000,6037553000,2019,518,460,88.800003,416,44
1400000US06037553100,6037553100,2019,2831,2238,79.050003,1887,351
1400000US06037553300,6037553300,2019,370,304,82.160004,259,45
1400000US06037553502,6037553502,2019,5797,5564,95.980003,4909,655
1400000US06037553504,6037553504,2019,606,580,95.709999,507,73
1400000US06037553601,6037553601,2019,516,510,98.839996,472,38
1400000US06037553701,6037553701,2019,531,519,97.739998,467,52
1400000US06037553702,6037553702,2019,1400,1352,96.57,1248,104
1400000US06037553802,6037553802,2019,1252,1209,96.57,1084,125
1400000US06037553901,6037553901,2019,1015,969,95.470001,834,135
1400000US06037553902,6037553902,2019,1591,1524,95.790001,1375,149
1400000US06037554002,6037554002,2019,745,644,86.440002,580,64
1400000US06037554106,6037554106,2019,483,417,86.339996,374,43
1400000US06037554201,6037554201,2019,712,589,82.720001,519,70
1400000US06037554405,6037554405,2019,732,530,72.400002,468,62
1400000US06037554511,6037554511,2019,2016,548,27.18,431,117
1400000US06037554512,6037554512,2019,1613,405,25.110001,324,81
1400000US06037554514,6037554514,2019,557,389,69.839996,336,53
1400000US06037554515,6037554515,2019,767,251,32.720001,217,34
1400000US06037554516,6037554516,2019,3919,1481,37.790001,1208,273
1400000US06037554517,6037554517,2019,766,153,19.969999,128,25
1400000US06037554518,6037554518,2019,673,146,21.690001,126,20
1400000US06037554521,6037554521,2019,1894,1006,53.119999,818,188
1400000US06037554522,6037554522,2019,1198,585,48.830002,496,89
1400000US06037554700,6037554700,2019,301,282,93.690002,272,10
1400000US06037554801,6037554801,2019,665,466,70.080002,394,72
1400000US06037554802,6037554802,2019,1584,956,60.349998,793,163
1400000US06037555001,6037555001,2019,423,378,89.360001,320,58
1400000US06037555002,6037555002,2019,356,308,86.519997,272,36
1400000US06037555105,6037555105,2019,1991,1426,71.620003,1261,165
1400000US06037555106,6037555106,2019,432,401,92.82,369,32
1400000US06037555107,6037555107,2019,444,414,93.239998,381,33
1400000US06037555211,6037555211,2019,364,349,95.879997,319,30
1400000US06037555212,6037555212,2019,345,326,94.489998,309,17
1400000US06037555300,6037555300,2019,390,285,73.080002,221,64
1400000US06037570001,6037570001,2019,3638,2018,55.470001,1722,296
1400000US06037570002,6037570002,2019,562,483,85.940002,437,46
1400000US06037570100,6037570100,2019,577,555,96.190002,510,45
1400000US06037570202,6037570202,2019,932,841,90.239998,748,93
1400000US06037570203,6037570203,2019,658,593,90.120003,534,59
1400000US06037570402,6037570402,2019,1066,964,90.43,858,106
1400000US06037570403,6037570403,2019,700,615,87.860001,566,49
1400000US06037570504,6037570504,2019,3478,2933,84.330002,2634,299
1400000US06037570601,6037570601,2019,627,568,90.589996,526,42
1400000US06037570602,6037570602,2019,903,808,89.480003,720,88
1400000US06037570701,6037570701,2019,645,543,84.190002,457,86
1400000US06037570800,6037570800,2019,1430,756,52.869999,631,125
1400000US06037570902,6037570902,2019,692,389,56.209999,316,73
1400000US06037571000,6037571000,2019,456,144,31.58,127,17
1400000US06037571101,6037571101,2019,347,176,50.720001,153,23
1400000US06037571102,6037571102,2019,3168,1911,60.32,1584,327
1400000US06037571202,6037571202,2019,1498,811,54.139999,690,121
1400000US06037571300,6037571300,2019,1136,830,73.059998,688,142
1400000US06037571400,6037571400,2019,352,198,56.25,150,48
1400000US06037571502,6037571502,2019,524,468,89.309998,428,40
1400000US06037571701,6037571701,2019,1749,1610,92.050003,1467,143
1400000US06037571703,6037571703,2019,896,840,93.75,771,69
1400000US06037571800,6037571800,2019,508,243,47.830002,212,31
1400000US06037571900,6037571900,2019,2444,1359,55.610001,1120,239
1400000US06037572202,6037572202,2019,1532,1355,88.449997,1231,124
1400000US06037572500,6037572500,2019,554,497,89.709999,454,43
1400000US06037572600,6037572600,2019,797,730,91.589996,638,92
1400000US06037572700,6037572700,2019,695,635,91.370003,558,77
1400000US06037573101,6037573101,2019,895,782,87.370003,723,59
1400000US06037573201,6037573201,2019,836,776,92.82,705,71
1400000US06037573300,6037573300,2019,403,321,79.650002,287,34
1400000US06037573402,6037573402,2019,1508,1353,89.720001,1214,139
1400000US06037573601,6037573601,2019,394,173,43.91,153,20
1400000US06037573700,6037573700,2019,837,214,25.57,164,50
1400000US06037573800,6037573800,2019,1090,517,47.43,432,85
1400000US06037573902,6037573902,2019,787,186,23.629999,142,44
1400000US06037574000,6037574000,2019,991,283,28.559999,231,52
1400000US06037574100,6037574100,2019,1401,574,40.970001,466,108
1400000US06037574201,6037574201,2019,430,235,54.650002,193,42
1400000US06037574202,6037574202,2019,142,117,82.389999,106,11
1400000US06037574300,6037574300,2019,1807,662,36.639999,560,102
1400000US06037574400,6037574400,2019,3887,1497,38.509998,1251,246
1400000US06037574500,6037574500,2019,704,307,43.610001,257,50
1400000US06037574602,6037574602,2019,398,155,38.939999,131,24
1400000US06037574901,6037574901,2019,547,146,26.690001,126,20
1400000US06037575001,6037575001,2019,279,223,79.93,206,17
1400000US06037575002,6037575002,2019,356,299,83.989998,252,47
1400000US06037575101,6037575101,2019,823,737,89.550003,680,57
1400000US06037575201,6037575201,2019,932,842,90.339996,793,49
1400000US06037575300,6037575300,2019,4958,3663,73.879997,3324,339
1400000US06037575401,6037575401,2019,1627,1323,81.32,1261,62
1400000US06037575402,6037575402,2019,103,61,59.220001,56,5
1400000US06037575901,6037575901,2019,549,518,94.349998,494,24
1400000US06037576200,6037576200,2019,1011,879,86.940002,817,62
1400000US06037576301,6037576301,2019,1108,884,79.779999,820,64
1400000US06037576401,6037576401,2019,975,912,93.540001,880,32
1400000US06037576501,6037576501,2019,1279,1178,92.099998,1113,65
1400000US06037576801,6037576801,2019,690,621,90,569,52
1400000US06037576903,6037576903,2019,655,606,92.519997,573,33
1400000US06037577000,6037577000,2019,4665,3148,67.480003,2852,296
1400000US06037577100,6037577100,2019,874,460,52.630001,409,51
1400000US06037577501,6037577501,2019,332,62,18.67,59,3
1400000US06037577602,6037577602,2019,328,109,33.23,94,15
1400000US06037577606,6037577606,2019,1511,354,23.43,313,41
1400000US06037577700,6037577700,2019,1071,879,82.07,759,120
1400000US06037577800,6037577800,2019,601,398,66.220001,285,113
1400000US06037577900,6037577900,2019,501,339,67.660004,309,30
1400000US06037578000,6037578000,2019,2823,2367,83.849998,2163,204
1400000US06037599000,6037599000,2019,529,379,71.639999,325,54
1400000US06037600201,6037600201,2019,926,890,96.110001,877,13
1400000US06037600302,6037600302,2019,1886,1717,91.040001,1624,93
1400000US06037600303,6037600303,2019,734,709,96.589996,688,21
1400000US06037600501,6037600501,2019,298,270,90.599998,261,9
1400000US06037600602,6037600602,2019,1495,1268,84.82,1201,67
1400000US06037600702,6037600702,2019,258,223,86.43,197,26
1400000US06037600703,6037600703,2019,614,595,96.910004,562,33
1400000US06037600801,6037600801,2019,423,384,90.779999,366,18
1400000US06037600911,6037600911,2019,557,530,95.150002,500,30
1400000US06037601001,6037601001,2019,87,86,98.849998,86,0
1400000US06037601002,6037601002,2019,647,553,85.470001,495,58
1400000US06037601202,6037601202,2019,1017,930,91.449997,857,73
1400000US06037601211,6037601211,2019,1510,1280,84.769997,1187,93
1400000US06037601212,6037601212,2019,408,338,82.839996,282,56
1400000US06037601301,6037601301,2019,750,596,79.470001,553,43
1400000US06037601303,6037601303,2019,1155,952,82.419998,859,93
1400000US06037601401,6037601401,2019,650,565,86.919998,537,28
1400000US06037601402,6037601402,2019,512,478,93.360001,439,39
1400000US06037601501,6037601501,2019,249,124,49.799999,70,54
1400000US06037601502,6037601502,2019,1423,1342,94.309998,1219,123
1400000US06037601600,6037601600,2019,2174,2053,94.43,1820,233
1400000US06037601700,6037601700,2019,2001,1850,92.449997,1596,254
1400000US06037601802,6037601802,2019,592,565,95.440002,506,59
1400000US06037602003,6037602003,2019,379,360,94.989998,327,33
1400000US06037602104,6037602104,2019,511,469,91.779999,420,49
1400000US06037602106,6037602106,2019,1429,1220,85.370003,1071,149
1400000US06037602201,6037602201,2019,3263,2037,62.43,1760,277
1400000US06037602302,6037602302,2019,1909,734,38.450001,560,174
1400000US06037602402,6037602402,2019,742,510,68.730003,436,74
1400000US06037602403,6037602403,2019,1412,1258,89.089996,1137,121
1400000US06037602404,6037602404,2019,559,498,89.089996,452,46
1400000US06037602505,6037602505,2019,833,732,87.879997,668,64
1400000US06037602506,6037602506,2019,718,630,87.739998,587,43
1400000US06037602511,6037602511,2019,1749,1585,90.620003,1471,114
1400000US06037602601,6037602601,2019,444,387,87.160004,348,39
1400000US06037602700,6037602700,2019,293,226,77.129997,209,17
1400000US06037602801,6037602801,2019,1142,1060,92.82,983,77
1400000US06037602802,6037602802,2019,1136,1075,94.629997,1020,55
1400000US06037603006,6037603006,2019,364,305,83.790001,292,13
1400000US06037603008,6037603008,2019,749,630,84.110001,583,47
1400000US06037603200,6037603200,2019,1320,1122,85,995,127
1400000US06037603301,6037603301,2019,1987,1661,83.589996,1424,237
1400000US06037603400,6037603400,2019,769,572,74.379997,479,93
1400000US06037603702,6037603702,2019,564,392,69.5,329,63
1400000US06037603705,6037603705,2019,178,146,82.019997,145,1
1400000US06037603706,6037603706,2019,591,537,90.860001,488,49
1400000US06037603801,6037603801,2019,1865,1570,84.18,1402,168
1400000US06037603802,6037603802,2019,1635,1378,84.279999,1219,159
1400000US06037603901,6037603901,2019,3314,2743,82.769997,2397,346
1400000US06037603902,6037603902,2019,842,687,81.589996,607,80
1400000US06037604001,6037604001,2019,510,416,81.57,350,66
1400000US06037604002,6037604002,2019,670,577,86.120003,522,55
1400000US06037604200,6037604200,2019,1526,1310,85.849998,1206,104
1400000US06037620001,6037620001,2019,762,108,14.17,80,28
1400000US06037620002,6037620002,2019,825,143,17.33,116,27
1400000US06037620101,6037620101,2019,1805,264,14.63,214,50
1400000US06037620303,6037620303,2019,585,11,1.88,11,0
1400000US06037620305,6037620305,2019,649,9,1.39,9,0
1400000US06037620400,6037620400,2019,1862,77,4.1399999,70,7
1400000US06037620501,6037620501,2019,651,69,10.6,60,9
1400000US06037620521,6037620521,2019,455,103,22.639999,89,14
1400000US06037620602,6037620602,2019,1867,415,22.23,352,63
1400000US06037620701,6037620701,2019,457,63,13.79,55,8
1400000US06037620703,6037620703,2019,612,33,5.3899999,33,0
1400000US06037620802,6037620802,2019,2918,193,6.6100001,171,22
1400000US06037620904,6037620904,2019,372,8,2.1500001,8,0
1400000US06037621005,6037621005,2019,1328,53,3.99,52,1
1400000US06037621201,6037621201,2019,4704,784,16.67,654,130
1400000US06037621301,6037621301,2019,647,68,10.51,58,10
1400000US06037621400,6037621400,2019,447,63,14.09,58,5
1400000US06037650001,6037650001,2019,1144,461,40.299999,384,77
1400000US06037650004,6037650004,2019,361,227,62.880001,193,34
1400000US06037650101,6037650101,2019,570,226,39.650002,180,46
1400000US06037650200,6037650200,2019,2521,1166,46.25,924,242
1400000US06037650300,6037650300,2019,586,298,50.849998,234,64
1400000US06037650401,6037650401,2019,1277,452,35.400002,383,69
1400000US06037650502,6037650502,2019,1258,225,17.889999,185,40
1400000US06037650603,6037650603,2019,3010,774,25.709999,645,129
1400000US06037650701,6037650701,2019,636,130,20.440001,96,34
1400000US06037650702,6037650702,2019,630,71,11.27,65,6
1400000US06037650903,6037650903,2019,1927,654,33.939999,528,126
1400000US06037650904,6037650904,2019,608,406,66.779999,355,51
1400000US06037651001,6037651001,2019,693,360,51.950001,292,68
1400000US06037651002,6037651002,2019,815,311,38.16,255,56
1400000US06037651101,6037651101,2019,949,159,16.75,130,29
1400000US06037651201,6037651201,2019,491,78,15.89,64,14
1400000US06037651221,6037651221,2019,694,149,21.469999,126,23
1400000US06037651222,6037651222,2019,2689,506,18.82,408,98
1400000US06037651302,6037651302,2019,1395,225,16.129999,194,31
1400000US06037651402,6037651402,2019,662,112,16.92,93,19
1400000US06037670002,6037670002,2019,1332,1127,84.610001,988,139
1400000US06037670003,6037670003,2019,927,627,67.639999,514,113
1400000US06037670101,6037670101,2019,483,405,83.849998,355,50
1400000US06037670202,6037670202,2019,410,42,10.24,39,3
1400000US06037670324,6037670324,2019,648,46,7.0999999,43,3
1400000US06037670326,6037670326,2019,435,28,6.4400001,26,2
1400000US06037670328,6037670328,2019,2848,160,5.6199999,151,9
1400000US06037670405,6037670405,2019,939,85,9.0500002,79,6
1400000US06037670413,6037670413,2019,414,37,8.9399996,33,4
1400000US06037670416,6037670416,2019,314,41,13.06,36,5
1400000US06037670417,6037670417,2019,2697,247,9.1599998,225,22
1400000US06037670418,6037670418,2019,912,48,5.2600002,47,1
1400000US06037670500,6037670500,2019,42,11,26.190001,11,0
1400000US06037670604,6037670604,2019,348,25,7.1799998,21,4
1400000US06037670701,6037670701,2019,2113,1367,64.690002,1113,254
1400000US06037670702,6037670702,2019,915,97,10.6,87,10
1400000US06037700200,6037700200,2019,1773,862,48.619999,716,146
1400000US06037700400,6037700400,2019,287,139,48.43,110,29
1400000US06037700501,6037700501,2019,420,81,19.290001,70,11
1400000US06037700600,6037700600,2019,542,88,16.24,78,10
1400000US06037700700,6037700700,2019,550,56,10.18,53,3
1400000US06037700901,6037700901,2019,561,103,18.360001,95,8
1400000US06037700902,6037700902,2019,673,127,18.870001,122,5
1400000US06037701000,6037701000,2019,1345,230,17.1,222,8
1400000US06037701304,6037701304,2019,754,94,12.47,76,18
1400000US06037701501,6037701501,2019,1102,213,19.33,171,42
1400000US06037701601,6037701601,2019,744,39,5.2399998,32,7
1400000US06037701602,6037701602,2019,458,156,34.060001,123,33
1400000US06037701801,6037701801,2019,426,177,41.549999,148,29
1400000US06037701902,6037701902,2019,2767,744,26.889999,626,118
1400000US06037702002,6037702002,2019,540,179,33.150002,156,23
1400000US06037702201,6037702201,2019,1524,598,39.240002,486,112
1400000US06037702300,6037702300,2019,558,162,29.030001,129,33
1400000US06037702400,6037702400,2019,598,168,28.09,146,22
1400000US06037702600,6037702600,2019,1394,288,20.66,245,43
1400000US06037702700,6037702700,2019,4450,1414,31.780001,1218,196
1400000US06037702801,6037702801,2019,574,323,56.27,291,32
1400000US06037702803,6037702803,2019,643,384,59.720001,340,44
1400000US06037703002,6037703002,2019,512,395,77.150002,353,42
1400000US06037703100,6037703100,2019,525,424,80.760002,378,46
1400000US06037703200,6037703200,2019,304,254,83.550003,238,16
1400000US06037800101,6037800101,2019,3379,382,11.31,329,53
1400000US06037800103,6037800103,2019,279,42,15.05,40,2
1400000US06037800202,6037800202,2019,1370,151,11.02,138,13
1400000US06037800205,6037800205,2019,549,119,21.68,106,13
1400000US06037800206,6037800206,2019,560,41,7.3200002,33,8
1400000US06037800325,6037800325,2019,439,35,7.9699998,31,4
1400000US06037800334,6037800334,2019,2678,375,14,345,30
1400000US06037800338,6037800338,2019,1951,193,9.8900003,161,32
1400000US06037800406,6037800406,2019,37,37,100,37,0
1400000US06037800411,6037800411,2019,1114,147,13.2,131,16
1400000US06037800412,6037800412,2019,171,13,7.5999999,13,0
1400000US06037800504,6037800504,2019,264,32,12.12,24,8
1400000US06037900102,6037900102,2019,667,630,94.449997,591,39
1400000US06037900103,6037900103,2019,547,522,95.43,470,52
1400000US06037900104,6037900104,2019,529,508,96.029999,507,1
1400000US06037900301,6037900301,2019,726,641,88.290001,609,32
1400000US06037900501,6037900501,2019,528,497,94.129997,446,51
1400000US06037900504,6037900504,2019,4495,3897,86.699997,3442,455
1400000US06037900505,6037900505,2019,716,670,93.580002,606,64
1400000US06037900508,6037900508,2019,2345,1902,81.110001,1722,180
1400000US06037900510,6037900510,2019,1347,1169,86.790001,1120,49
1400000US06037900602,6037900602,2019,946,904,95.559998,833,71
1400000US06037900606,6037900606,2019,2961,2275,76.830002,2184,91
1400000US06037900607,6037900607,2019,664,626,94.279999,575,51
1400000US06037900609,6037900609,2019,770,718,93.25,634,84
1400000US06037900610,6037900610,2019,591,521,88.160004,484,37
1400000US06037900701,6037900701,2019,1094,966,88.300003,898,68
1400000US06037900703,6037900703,2019,1231,1066,86.599998,973,93
1400000US06037900804,6037900804,2019,545,511,93.760002,475,36
1400000US06037900805,6037900805,2019,745,676,90.739998,596,80
1400000US06037900807,6037900807,2019,701,652,93.010002,585,67
1400000US06037900901,6037900901,2019,813,388,47.720001,322,66
1400000US06037901007,6037901007,2019,777,483,62.16,441,42
1400000US06037901009,6037901009,2019,958,820,85.589996,700,120
1400000US06037901010,6037901010,2019,795,671,84.400002,567,104
1400000US06037901011,6037901011,2019,802,641,79.93,543,98
1400000US06037901012,6037901012,2019,695,561,80.720001,475,86
1400000US06037901013,6037901013,2019,1174,751,63.970001,597,154
1400000US06037901014,6037901014,2019,2497,1467,58.75,1348,119
1400000US06037901101,6037901101,2019,1096,541,49.360001,481,60
1400000US06037901209,6037901209,2019,335,202,60.299999,180,22
1400000US06037901214,6037901214,2019,959,516,53.810001,451,65
1400000US06037901215,6037901215,2019,3407,1383,40.59,1226,157
1400000US06037901217,6037901217,2019,92,19,20.65,16,3
1400000US06037901300,6037901300,2019,562,507,90.209999,479,28
1400000US06037910002,6037910002,2019,293,246,83.959999,244,2
1400000US06037910210,6037910210,2019,1075,550,51.16,470,80
1400000US06037910212,6037910212,2019,912,219,24.01,188,31
1400000US06037910214,6037910214,2019,4240,2775,65.449997,2462,313
1400000US06037910215,6037910215,2019,1662,1295,77.919998,1132,163
1400000US06037910217,6037910217,2019,728,391,53.709999,318,73
1400000US06037910218,6037910218,2019,592,336,56.759998,328,8
1400000US06037910301,6037910301,2019,831,523,62.939999,474,49
1400000US06037910302,6037910302,2019,1726,780,45.189999,698,82
1400000US06037910401,6037910401,2019,693,512,73.879997,454,58
1400000US06037910404,6037910404,2019,618,577,93.370003,524,53
1400000US06037910405,6037910405,2019,1490,1277,85.699997,1170,107
1400000US06037910504,6037910504,2019,786,745,94.779999,693,52
1400000US06037910601,6037910601,2019,683,612,89.599998,561,51
1400000US06037910602,6037910602,2019,5064,4241,83.75,3790,451
1400000US06037910605,6037910605,2019,926,821,88.660004,715,106
1400000US06037910606,6037910606,2019,144,106,73.610001,105,1
1400000US06037910608,6037910608,2019,778,706,90.75,614,92
1400000US06037910706,6037910706,2019,753,652,86.589996,574,78
1400000US06037910712,6037910712,2019,565,494,87.43,416,78
1400000US06037910714,6037910714,2019,1899,1577,83.040001,1427,150
1400000US06037910715,6037910715,2019,584,513,87.839996,447,66
1400000US06037910716,6037910716,2019,1630,1390,85.279999,1193,197
1400000US06037910717,6037910717,2019,4290,3353,78.160004,2821,532
1400000US06037910718,6037910718,2019,1600,1349,84.309998,1159,190
1400000US06037910720,6037910720,2019,782,706,90.279999,629,77
1400000US06037910804,6037910804,2019,2684,778,28.99,734,44
1400000US06037910807,6037910807,2019,985,545,55.330002,463,82
1400000US06037910814,6037910814,2019,107,34,31.780001,31,3
1400000US06037910815,6037910815,2019,6842,2882,42.119999,2502,380
1400000US06037911001,6037911001,2019,842,732,86.940002,730,2
1400000US06037911100,6037911100,2019,2347,2020,86.07,1909,111
1400000US06037920013,6037920013,2019,892,127,14.24,104,23
1400000US06037920015,6037920015,2019,846,95,11.23,86,9
1400000US06037920017,6037920017,2019,940,227,24.15,190,37
1400000US06037920020,6037920020,2019,687,188,27.370001,153,35
1400000US06037920029,6037920029,2019,2599,1008,38.779999,830,178
1400000US06037920031,6037920031,2019,3330,1684,50.57,1488,196
1400000US06037920034,6037920034,2019,1071,623,58.169998,541,82
1400000US06037920035,6037920035,2019,504,423,83.93,376,47
1400000US06037920041,6037920041,2019,1857,521,28.059999,457,64
1400000US06037920042,6037920042,2019,562,403,71.709999,361,42
1400000US06037920043,6037920043,2019,1498,531,35.450001,434,97
1400000US06037920044,6037920044,2019,2449,415,16.950001,368,47
1400000US06037920048,6037920048,2019,2027,1215,59.939999,1051,164
1400000US06037920049,6037920049,2019,711,111,15.61,100,11
1400000US06037920102,6037920102,2019,718,262,36.490002,229,33
1400000US06037920109,6037920109,2019,652,112,17.18,92,20
1400000US06037920111,6037920111,2019,368,102,27.719999,86,16
1400000US06037920112,6037920112,2019,1329,249,18.74,216,33
1400000US06037920115,6037920115,2019,1480,212,14.32,183,29
1400000US06037920118,6037920118,2019,2071,603,29.120001,527,76
1400000US06037920119,6037920119,2019,466,86,18.450001,74,12
1400000US06037920120,6037920120,2019,580,82,14.14,74,8
1400000US06037920121,6037920121,2019,5535,899,16.24,778,121
1400000US06037920313,6037920313,2019,973,654,67.209999,597,57
1400000US06037920314,6037920314,2019,565,229,40.529999,209,20
1400000US06037920322,6037920322,2019,399,163,40.849998,144,19
1400000US06037920326,6037920326,2019,895,166,18.549999,139,27
1400000US06037920329,6037920329,2019,891,231,25.93,204,27
1400000US06037920330,6037920330,2019,406,57,14.04,50,7
1400000US06037920334,6037920334,2019,708,113,15.96,101,12
1400000US06037920338,6037920338,2019,780,87,11.15,79,8
1400000US06037920339,6037920339,2019,4079,587,14.39,513,74
1400000US06037920340,6037920340,2019,3259,1315,40.349998,1206,109
1400000US06037920341,6037920341,2019,631,588,93.190002,538,50
1400000US06037920342,6037920342,2019,673,588,87.370003,536,52
1400000US06037930400,6037930400,2019,94,28,29.790001,26,2
1400000US06037980004,6037980004,2019,762,741,97.239998,708,33
1400000US06037980013,6037980013,2019,1039,459,44.18,383,76
1400000US06037980016,6037980016,2019,203,185,91.129997,179,6
1400000US06037101110,6037101110,2018,1283,978,76.230003,818,160
1400000US06037101220,6037101220,2018,227,216,95.150002,197,19
1400000US06037101300,6037101300,2018,363,229,63.09,198,31
1400000US06037102107,6037102107,2018,720,600,83.330002,495,105
1400000US06037103101,6037103101,2018,768,589,76.690002,500,89
1400000US06037103102,6037103102,2018,666,537,80.629997,484,53
1400000US06037103202,6037103202,2018,152,120,78.949997,104,16
1400000US06037103402,6037103402,2018,409,235,57.459999,199,36
1400000US06037104103,6037104103,2018,758,689,90.900002,555,134
1400000US06037104105,6037104105,2018,1033,902,87.32,749,153
1400000US06037104108,6037104108,2018,1381,1266,91.669998,1187,79
1400000US06037104124,6037104124,2018,1168,948,81.160004,817,131
1400000US06037104204,6037104204,2018,497,477,95.980003,455,22
1400000US06037104310,6037104310,2018,2914,2842,97.529999,2498,344
1400000US06037104321,6037104321,2018,1242,1031,83.010002,979,52
1400000US06037104401,6037104401,2018,671,639,95.230003,602,37
1400000US06037104500,6037104500,2018,777,718,92.410004,667,51
1400000US06037104821,6037104821,2018,795,724,91.07,660,64
1400000US06037104822,6037104822,2018,1190,1089,91.510002,1003,86
1400000US06037106020,6037106020,2018,214,171,79.910004,157,14
1400000US06037106112,6037106112,2018,571,482,84.410004,430,52
1400000US06037106113,6037106113,2018,395,303,76.709999,239,64
1400000US06037106114,6037106114,2018,419,373,89.019997,324,49
1400000US06037106403,6037106403,2018,2177,1867,85.760002,1678,189
1400000US06037106405,6037106405,2018,2602,2327,89.43,2088,239
1400000US06037106510,6037106510,2018,155,155,100,155,0
1400000US06037106520,6037106520,2018,1716,1397,81.410004,1240,157
1400000US06037106603,6037106603,2018,455,186,40.880001,140,46
1400000US06037106604,6037106604,2018,451,409,90.690002,376,33
1400000US06037106641,6037106641,2018,1617,843,52.130001,649,194
1400000US06037106642,6037106642,2018,451,135,29.93,104,31
1400000US06037106646,6037106646,2018,2633,2025,76.910004,1613,412
1400000US06037106648,6037106648,2018,316,281,88.919998,258,23
1400000US06037107020,6037107020,2018,663,587,88.540001,526,61
1400000US06037108104,6037108104,2018,727,153,21.049999,120,33
1400000US06037108202,6037108202,2018,1149,166,14.45,141,25
1400000US06037109200,6037109200,2018,376,278,73.940002,228,50
1400000US06037109300,6037109300,2018,588,435,73.980003,342,93
1400000US06037109500,6037109500,2018,2016,1844,91.470001,1610,234
1400000US06037109601,6037109601,2018,653,502,76.879997,411,91
1400000US06037109700,6037109700,2018,1532,1105,72.129997,891,214
1400000US06037109800,6037109800,2018,827,485,58.650002,355,130
1400000US06037111100,6037111100,2018,479,335,69.940002,274,61
1400000US06037111202,6037111202,2018,413,283,68.519997,234,49
1400000US06037111204,6037111204,2018,3006,1370,45.580002,1057,313
1400000US06037111206,6037111206,2018,458,233,50.869999,185,48
1400000US06037111302,6037111302,2018,408,266,65.199997,219,47
1400000US06037111303,6037111303,2018,2295,1522,66.32,1225,297
1400000US06037111304,6037111304,2018,4653,2262,48.610001,1577,685
1400000US06037111401,6037111401,2018,444,302,68.019997,237,65
1400000US06037113101,6037113101,2018,486,282,58.02,242,40
1400000US06037113212,6037113212,2018,388,255,65.720001,219,36
1400000US06037113232,6037113232,2018,377,319,84.620003,299,20
1400000US06037113303,6037113303,2018,627,393,62.68,345,48
1400000US06037113322,6037113322,2018,449,134,29.84,115,19
1400000US06037113323,6037113323,2018,1423,881,61.91,746,135
1400000US06037113324,6037113324,2018,1873,1299,69.349998,1111,188
1400000US06037113423,6037113423,2018,141,105,74.470001,92,13
1400000US06037113428,6037113428,2018,787,714,90.720001,665,49
1400000US06037115101,6037115101,2018,2597,1514,58.299999,1258,256
1400000US06037115103,6037115103,2018,1057,770,72.849998,645,125
1400000US06037115202,6037115202,2018,554,373,67.330002,310,63
1400000US06037115301,6037115301,2018,594,231,38.889999,190,41
1400000US06037115302,6037115302,2018,452,421,93.139999,391,30
1400000US06037115401,6037115401,2018,822,751,91.360001,707,44
1400000US06037115403,6037115403,2018,285,204,71.580002,183,21
1400000US06037117101,6037117101,2018,3032,2820,93.010002,2631,189
1400000US06037117102,6037117102,2018,457,397,86.870003,353,44
1400000US06037117202,6037117202,2018,2532,2257,89.139999,2093,164
1400000US06037117302,6037117302,2018,562,509,90.57,477,32
1400000US06037117303,6037117303,2018,264,97,36.740002,66,31
1400000US06037117407,6037117407,2018,586,580,98.980003,569,11
1400000US06037117510,6037117510,2018,496,465,93.75,372,93
1400000US06037117520,6037117520,2018,692,657,94.940002,638,19
1400000US06037117530,6037117530,2018,858,802,93.470001,760,42
1400000US06037119003,6037119003,2018,643,605,94.089996,557,48
1400000US06037119004,6037119004,2018,532,430,80.830002,383,47
1400000US06037119201,6037119201,2018,1877,1682,89.610001,1515,167
1400000US06037119342,6037119342,2018,677,617,91.139999,580,37
1400000US06037119802,6037119802,2018,848,710,83.730003,605,105
1400000US06037119900,6037119900,2018,749,677,90.389999,595,82
1400000US06037120010,6037120010,2018,1174,1130,96.25,1087,43
1400000US06037120020,6037120020,2018,768,730,95.050003,709,21
1400000US06037120030,6037120030,2018,1427,1330,93.199997,1269,61
1400000US06037120107,6037120107,2018,493,475,96.349998,463,12
1400000US06037120108,6037120108,2018,999,971,97.199997,944,27
1400000US06037120300,6037120300,2018,358,341,95.25,319,22
1400000US06037120400,6037120400,2018,495,440,88.889999,400,40
1400000US06037121010,6037121010,2018,4167,3760,90.230003,3368,392
1400000US06037121020,6037121020,2018,572,517,90.379997,475,42
1400000US06037121102,6037121102,2018,277,237,85.559998,210,27
1400000US06037121210,6037121210,2018,367,310,84.470001,272,38
1400000US06037121222,6037121222,2018,1556,1422,91.389999,1277,145
1400000US06037121600,6037121600,2018,93,73,78.489998,63,10
1400000US06037121801,6037121801,2018,446,422,94.620003,406,16
1400000US06037121900,6037121900,2018,438,412,94.059998,371,41
1400000US06037122000,6037122000,2018,555,479,86.309998,418,61
1400000US06037122122,6037122122,2018,559,519,92.839996,491,28
1400000US06037122200,6037122200,2018,303,271,89.440002,243,28
1400000US06037122420,6037122420,2018,564,527,93.440002,499,28
1400000US06037123010,6037123010,2018,1889,1715,90.790001,1622,93
1400000US06037123301,6037123301,2018,531,502,94.540001,477,25
1400000US06037123303,6037123303,2018,754,713,94.559998,675,38
1400000US06037123420,6037123420,2018,1760,1625,92.330002,1499,126
1400000US06037123510,6037123510,2018,787,728,92.5,684,44
1400000US06037123601,6037123601,2018,1899,1608,84.68,1460,148
1400000US06037123602,6037123602,2018,669,592,88.489998,533,59
1400000US06037123700,6037123700,2018,688,530,77.029999,460,70
1400000US06037123901,6037123901,2018,2026,1897,93.629997,1799,98
1400000US06037124102,6037124102,2018,767,601,78.360001,580,21
1400000US06037124201,6037124201,2018,744,689,92.610001,636,53
1400000US06037124300,6037124300,2018,366,341,93.169998,313,28
1400000US06037124600,6037124600,2018,1833,832,45.389999,725,107
1400000US06037124700,6037124700,2018,604,223,36.919998,196,27
1400000US06037124902,6037124902,2018,387,293,75.709999,253,40
1400000US06037125101,6037125101,2018,2484,1849,74.440002,1656,193
1400000US06037125102,6037125102,2018,624,159,25.48,143,16
1400000US06037125310,6037125310,2018,714,524,73.389999,485,39
1400000US06037125322,6037125322,2018,387,346,89.410004,327,19
1400000US06037125600,6037125600,2018,426,334,78.400002,275,59
1400000US06037127210,6037127210,2018,2382,2244,94.209999,2126,118
1400000US06037127400,6037127400,2018,510,471,92.349998,441,30
1400000US06037127603,6037127603,2018,765,719,93.989998,681,38
1400000US06037127803,6037127803,2018,325,186,57.23,169,17
1400000US06037127805,6037127805,2018,500,467,93.400002,452,15
1400000US06037127806,6037127806,2018,2695,2181,80.93,1953,228
1400000US06037127910,6037127910,2018,1183,791,66.860001,693,98
1400000US06037127920,6037127920,2018,749,698,93.190002,668,30
1400000US06037128102,6037128102,2018,903,795,88.040001,721,74
1400000US06037128302,6037128302,2018,812,775,95.440002,741,34
1400000US06037128602,6037128602,2018,505,268,53.07,237,31
1400000US06037128802,6037128802,2018,2082,1462,70.220001,1289,173
1400000US06037128910,6037128910,2018,218,111,50.919998,85,26
1400000US06037131022,6037131022,2018,497,459,92.349998,427,32
1400000US06037131023,6037131023,2018,384,345,89.839996,326,19
1400000US06037131100,6037131100,2018,393,313,79.639999,278,35
1400000US06037131200,6037131200,2018,556,385,69.239998,331,54
1400000US06037131300,6037131300,2018,447,401,89.709999,364,37
1400000US06037131600,6037131600,2018,3393,2324,68.489998,2017,307
1400000US06037131701,6037131701,2018,52,26,50,21,5
1400000US06037131801,6037131801,2018,894,804,89.93,724,80
1400000US06037131900,6037131900,2018,413,366,88.620003,322,44
1400000US06037132001,6037132001,2018,399,325,81.449997,260,65
1400000US06037132002,6037132002,2018,6608,5451,82.489998,4790,661
1400000US06037132301,6037132301,2018,376,335,89.099998,304,31
1400000US06037132501,6037132501,2018,17,12,70.589996,12,0
1400000US06037132700,6037132700,2018,2030,1703,83.889999,1536,167
1400000US06037133000,6037133000,2018,436,367,84.169998,333,34
1400000US06037133101,6037133101,2018,386,327,84.720001,285,42
1400000US06037133102,6037133102,2018,2075,1188,57.25,949,239
1400000US06037134001,6037134001,2018,722,687,95.150002,665,22
1400000US06037134002,6037134002,2018,457,259,56.669998,207,52
1400000US06037134101,6037134101,2018,488,427,87.5,403,24
1400000US06037134103,6037134103,2018,509,470,92.339996,434,36
1400000US06037134104,6037134104,2018,391,361,92.330002,325,36
1400000US06037134302,6037134302,2018,411,337,82,288,49
1400000US06037134303,6037134303,2018,590,559,94.75,544,15
1400000US06037134304,6037134304,2018,1171,1036,88.470001,947,89
1400000US06037134421,6037134421,2018,626,163,26.040001,140,23
1400000US06037134422,6037134422,2018,254,181,71.260002,149,32
1400000US06037134423,6037134423,2018,377,139,36.869999,102,37
1400000US06037134520,6037134520,2018,1381,1221,88.410004,1104,117
1400000US06037134522,6037134522,2018,754,674,89.389999,648,26
1400000US06037134720,6037134720,2018,1484,1356,91.370003,1241,115
1400000US06037134801,6037134801,2018,418,368,88.040001,330,38
1400000US06037135102,6037135102,2018,313,169,53.990002,145,24
1400000US06037135202,6037135202,2018,810,130,16.049999,112,18
1400000US06037135204,6037135204,2018,881,223,25.309999,191,32
1400000US06037137000,6037137000,2018,3483,1101,31.610001,963,138
1400000US06037137104,6037137104,2018,694,580,83.57,508,72
1400000US06037137203,6037137203,2018,683,478,69.989998,416,62
1400000US06037137301,6037137301,2018,519,210,40.459999,179,31
1400000US06037137302,6037137302,2018,2191,777,35.459999,639,138
1400000US06037137401,6037137401,2018,688,121,17.59,107,14
1400000US06037137402,6037137402,2018,418,88,21.049999,77,11
1400000US06037137501,6037137501,2018,3018,1845,61.130001,1566,279
1400000US06037139001,6037139001,2018,323,119,36.84,104,15
1400000US06037139200,6037139200,2018,405,281,69.379997,240,41
1400000US06037139301,6037139301,2018,759,592,78,521,71
1400000US06037139402,6037139402,2018,3228,1293,40.060001,1118,175
1400000US06037139502,6037139502,2018,505,315,62.380001,265,50
1400000US06037139600,6037139600,2018,565,143,25.309999,131,12
1400000US06037139701,6037139701,2018,574,46,8.0100002,38,8
1400000US06037141101,6037141101,2018,722,183,25.35,156,27
1400000US06037141304,6037141304,2018,806,241,29.9,213,28
1400000US06037141400,6037141400,2018,551,96,17.42,89,7
1400000US06037143200,6037143200,2018,863,515,59.68,458,57
1400000US06037143302,6037143302,2018,1584,852,53.790001,735,117
1400000US06037143700,6037143700,2018,235,57,24.26,50,7
1400000US06037143801,6037143801,2018,984,114,11.59,101,13
1400000US06037181000,6037181000,2018,862,718,83.290001,635,83
1400000US06037181400,6037181400,2018,834,442,53,367,75
1400000US06037181500,6037181500,2018,892,478,53.59,400,78
1400000US06037181600,6037181600,2018,2275,1393,61.23,1125,268
1400000US06037183101,6037183101,2018,1323,1168,88.279999,1076,92
1400000US06037183104,6037183104,2018,255,207,81.18,173,34
1400000US06037183220,6037183220,2018,219,193,88.129997,171,22
1400000US06037183221,6037183221,2018,85,79,92.940002,79,0
1400000US06037183401,6037183401,2018,368,306,83.150002,268,38
1400000US06037183402,6037183402,2018,318,276,86.790001,241,35
1400000US06037183510,6037183510,2018,1427,1336,93.620003,1193,143
1400000US06037183520,6037183520,2018,363,352,96.970001,332,20
1400000US06037183702,6037183702,2018,186,167,89.779999,154,13
1400000US06037183810,6037183810,2018,586,555,94.709999,506,49
1400000US06037185101,6037185101,2018,557,446,80.07,395,51
1400000US06037185102,6037185102,2018,487,381,78.230003,344,37
1400000US06037185204,6037185204,2018,397,74,18.639999,62,12
1400000US06037185310,6037185310,2018,1090,1021,93.669998,961,60
1400000US06037186100,6037186100,2018,423,265,62.650002,202,63
1400000US06037186302,6037186302,2018,161,133,82.610001,116,17
1400000US06037186401,6037186401,2018,1914,1663,86.889999,1504,159
1400000US06037186404,6037186404,2018,337,318,94.360001,300,18
1400000US06037187101,6037187101,2018,282,227,80.5,203,24
1400000US06037187102,6037187102,2018,1576,1048,66.5,915,133
1400000US06037187300,6037187300,2018,369,309,83.739998,260,49
1400000US06037188201,6037188201,2018,461,62,13.45,52,10
1400000US06037188300,6037188300,2018,298,223,74.830002,191,32
1400000US06037189201,6037189201,2018,488,408,83.610001,368,40
1400000US06037189501,6037189501,2018,284,192,67.610001,182,10
1400000US06037189905,6037189905,2018,404,230,56.93,197,33
1400000US06037190102,6037190102,2018,1489,1276,85.699997,1145,131
1400000US06037190510,6037190510,2018,503,431,85.690002,410,21
1400000US06037190701,6037190701,2018,140,129,92.139999,119,10
1400000US06037190901,6037190901,2018,1188,1083,91.160004,1003,80
1400000US06037190902,6037190902,2018,939,858,91.370003,806,52
1400000US06037191120,6037191120,2018,423,393,92.910004,381,12
1400000US06037191204,6037191204,2018,516,494,95.739998,473,21
1400000US06037191301,6037191301,2018,145,134,92.410004,125,9
1400000US06037191410,6037191410,2018,427,411,96.25,377,34
1400000US06037191720,6037191720,2018,903,882,97.669998,806,76
1400000US06037191810,6037191810,2018,453,418,92.269997,386,32
1400000US06037191901,6037191901,2018,801,698,87.139999,646,52
1400000US06037192001,6037192001,2018,311,169,54.34,146,23
1400000US06037192002,6037192002,2018,1883,1508,80.080002,1338,170
1400000US06037192410,6037192410,2018,211,187,88.629997,166,21
1400000US06037192520,6037192520,2018,413,379,91.769997,355,24
1400000US06037192620,6037192620,2018,666,631,94.739998,599,32
1400000US06037192700,6037192700,2018,439,413,94.080002,390,23
1400000US06037194300,6037194300,2018,514,65,12.65,57,8
1400000US06037195201,6037195201,2018,2830,1944,68.690002,1660,284
1400000US06037195300,6037195300,2018,2022,1511,74.730003,1282,229
1400000US06037195400,6037195400,2018,399,215,53.880001,183,32
1400000US06037195500,6037195500,2018,280,260,92.860001,230,30
1400000US06037195710,6037195710,2018,948,861,90.82,791,70
1400000US06037197200,6037197200,2018,300,256,85.330002,225,31
1400000US06037197300,6037197300,2018,290,200,68.970001,187,13
1400000US06037197410,6037197410,2018,154,119,77.269997,101,18
1400000US06037197420,6037197420,2018,813,719,88.440002,634,85
1400000US06037199001,6037199001,2018,179,133,74.300003,124,9
1400000US06037199002,6037199002,2018,311,299,96.139999,282,17
1400000US06037199120,6037199120,2018,284,247,86.970001,211,36
1400000US06037199201,6037199201,2018,360,268,74.440002,249,19
1400000US06037199202,6037199202,2018,1278,1211,94.760002,1134,77
1400000US06037199300,6037199300,2018,659,436,66.160004,430,6
1400000US06037199400,6037199400,2018,146,140,95.889999,135,5
1400000US06037199700,6037199700,2018,1644,1544,93.919998,1438,106
1400000US06037199801,6037199801,2018,409,380,92.910004,359,21
1400000US06037199802,6037199802,2018,622,575,92.440002,543,32
1400000US06037201120,6037201120,2018,219,183,83.559998,166,17
1400000US06037201200,6037201200,2018,353,316,89.519997,296,20
1400000US06037201301,6037201301,2018,336,319,94.940002,302,17
1400000US06037201401,6037201401,2018,1609,1464,90.989998,1332,132
1400000US06037201402,6037201402,2018,1862,1672,89.800003,1512,160
1400000US06037201501,6037201501,2018,310,293,94.519997,274,19
1400000US06037201602,6037201602,2018,365,323,88.489998,288,35
1400000US06037201700,6037201700,2018,531,95,17.889999,83,12
1400000US06037203100,6037203100,2018,458,444,96.940002,434,10
1400000US06037203200,6037203200,2018,738,720,97.559998,692,28
1400000US06037203300,6037203300,2018,2067,1861,90.029999,1655,206
1400000US06037203500,6037203500,2018,182,178,97.800003,168,10
1400000US06037203601,6037203601,2018,789,758,96.07,727,31
1400000US06037203800,6037203800,2018,603,573,95.019997,543,30
1400000US06037204110,6037204110,2018,326,300,92.019997,255,45
1400000US06037204300,6037204300,2018,2292,2182,95.199997,2042,140
1400000US06037204410,6037204410,2018,337,314,93.18,299,15
1400000US06037204420,6037204420,2018,887,842,94.93,799,43
1400000US06037204700,6037204700,2018,2311,2185,94.550003,2004,181
1400000US06037204810,6037204810,2018,1534,1465,95.5,1401,64
1400000US06037204820,6037204820,2018,595,565,94.959999,515,50
1400000US06037204910,6037204910,2018,1366,1294,94.730003,1189,105
1400000US06037205110,6037205110,2018,1057,988,93.470001,931,57
1400000US06037205120,6037205120,2018,112,103,91.959999,100,3
1400000US06037206010,6037206010,2018,332,248,74.699997,217,31
1400000US06037206050,6037206050,2018,70,59,84.290001,52,7
1400000US06037206051,6037206051,2018,455,437,96.040001,411,26
1400000US06037206054,6037206054,2018,1487,1399,94.080002,1316,83
1400000US06037207101,6037207101,2018,1247,927,74.339996,803,124
1400000US06037207103,6037207103,2018,656,403,61.43,397,6
1400000US06037207400,6037207400,2018,379,365,96.309998,363,2
1400000US06037207502,6037207502,2018,106,99,93.400002,85,14
1400000US06037208001,6037208001,2018,2973,2713,91.25,2520,193
1400000US06037208002,6037208002,2018,587,547,93.190002,506,41
1400000US06037208302,6037208302,2018,1558,1438,92.300003,1384,54
1400000US06037208401,6037208401,2018,1060,1040,98.110001,1021,19
1400000US06037208501,6037208501,2018,946,506,53.490002,447,59
1400000US06037208610,6037208610,2018,493,477,96.75,453,24
1400000US06037208710,6037208710,2018,92,80,86.959999,78,2
1400000US06037208720,6037208720,2018,172,149,86.629997,114,35
1400000US06037208801,6037208801,2018,505,474,93.860001,469,5
1400000US06037208802,6037208802,2018,468,453,96.790001,446,7
1400000US06037208902,6037208902,2018,1333,1318,98.870003,1311,7
1400000US06037209103,6037209103,2018,834,778,93.290001,765,13
1400000US06037209104,6037209104,2018,378,377,99.739998,370,7
1400000US06037209106,6037209106,2018,978,941,96.220001,925,16
1400000US06037209202,6037209202,2018,1156,1108,95.849998,1069,39
1400000US06037209520,6037209520,2018,262,245,93.510002,232,13
1400000US06037209820,6037209820,2018,335,307,91.639999,285,22
1400000US06037210010,6037210010,2018,803,780,97.139999,763,17
1400000US06037211000,6037211000,2018,1790,1425,79.610001,1201,224
1400000US06037211121,6037211121,2018,1069,986,92.239998,927,59
1400000US06037211122,6037211122,2018,2788,2493,89.419998,2341,152
1400000US06037211123,6037211123,2018,906,877,96.800003,842,35
1400000US06037211124,6037211124,2018,664,611,92.019997,569,42
1400000US06037211202,6037211202,2018,737,710,96.339996,690,20
1400000US06037211410,6037211410,2018,664,566,85.239998,489,77
1400000US06037211420,6037211420,2018,474,388,81.860001,347,41
1400000US06037212202,6037212202,2018,694,650,93.660004,640,10
1400000US06037212204,6037212204,2018,794,743,93.580002,654,89
1400000US06037212303,6037212303,2018,249,231,92.769997,213,18
1400000US06037212304,6037212304,2018,3846,3596,93.5,3431,165
1400000US06037212610,6037212610,2018,993,868,87.410004,786,82
1400000US06037212800,6037212800,2018,1888,1534,81.25,1400,134
1400000US06037213201,6037213201,2018,619,594,95.959999,570,24
1400000US06037213202,6037213202,2018,745,706,94.769997,683,23
1400000US06037213310,6037213310,2018,163,155,95.089996,152,3
1400000US06037213320,6037213320,2018,1134,1092,96.300003,1049,43
1400000US06037213402,6037213402,2018,698,678,97.129997,666,12
1400000US06037214100,6037214100,2018,610,170,27.870001,137,33
1400000US06037214501,6037214501,2018,704,222,31.530001,196,26
1400000US06037216201,6037216201,2018,131,116,88.550003,107,9
1400000US06037216301,6037216301,2018,338,229,67.75,206,23
1400000US06037216700,6037216700,2018,1976,1255,63.509998,1061,194
1400000US06037217101,6037217101,2018,327,310,94.800003,293,17
1400000US06037218110,6037218110,2018,2058,1543,74.980003,1440,103
1400000US06037218210,6037218210,2018,479,455,94.989998,425,30
1400000US06037218300,6037218300,2018,308,281,91.230003,245,36
1400000US06037218800,6037218800,2018,590,572,96.949997,544,28
1400000US06037218900,6037218900,2018,776,695,89.559998,617,78
1400000US06037219010,6037219010,2018,541,499,92.239998,488,11
1400000US06037219300,6037219300,2018,616,498,80.839996,447,51
1400000US06037219700,6037219700,2018,948,714,75.32,682,32
1400000US06037219800,6037219800,2018,558,521,93.370003,494,27
1400000US06037219902,6037219902,2018,784,739,94.260002,693,46
1400000US06037220000,6037220000,2018,321,307,95.639999,288,19
1400000US06037220100,6037220100,2018,870,492,56.549999,437,55
1400000US06037221120,6037221120,2018,987,940,95.239998,908,32
1400000US06037221304,6037221304,2018,737,670,90.910004,641,29
1400000US06037221401,6037221401,2018,1094,1036,94.699997,985,51
1400000US06037221602,6037221602,2018,2245,2173,96.790001,2112,61
1400000US06037221810,6037221810,2018,598,571,95.480003,543,28
1400000US06037221900,6037221900,2018,393,362,92.110001,347,15
1400000US06037222002,6037222002,2018,619,566,91.440002,545,21
1400000US06037222500,6037222500,2018,1872,1657,88.510002,1545,112
1400000US06037222600,6037222600,2018,549,525,95.629997,506,19
1400000US06037224010,6037224010,2018,39,39,100,39,0
1400000US06037224020,6037224020,2018,1779,1667,93.699997,1581,86
1400000US06037224320,6037224320,2018,435,414,95.169998,381,33
1400000US06037224410,6037224410,2018,1907,1810,94.910004,1721,89
1400000US06037224420,6037224420,2018,937,882,94.129997,854,28
1400000US06037224600,6037224600,2018,1294,1250,96.599998,1214,36
1400000US06037224702,6037224702,2018,1050,943,89.809998,788,155
1400000US06037226001,6037226001,2018,3046,2944,96.650002,2847,97
1400000US06037226002,6037226002,2018,1102,1038,94.190002,1001,37
1400000US06037226702,6037226702,2018,1340,1296,96.720001,1246,50
1400000US06037227020,6037227020,2018,1335,1298,97.230003,1259,39
1400000US06037228100,6037228100,2018,1768,1716,97.059998,1667,49
1400000US06037228210,6037228210,2018,1736,1645,94.760002,1568,77
1400000US06037228310,6037228310,2018,1272,1224,96.230003,1180,44
1400000US06037228320,6037228320,2018,598,575,96.150002,550,25
1400000US06037228410,6037228410,2018,635,612,96.379997,587,25
1400000US06037228420,6037228420,2018,1232,1206,97.889999,1155,51
1400000US06037228500,6037228500,2018,566,543,95.940002,523,20
1400000US06037228600,6037228600,2018,1346,1303,96.809998,1263,40
1400000US06037228710,6037228710,2018,1165,1124,96.480003,1096,28
1400000US06037228720,6037228720,2018,807,783,97.029999,754,29
1400000US06037228800,6037228800,2018,234,225,96.150002,222,3
1400000US06037229200,6037229200,2018,701,677,96.580002,659,18
1400000US06037229300,6037229300,2018,441,427,96.830002,401,26
1400000US06037229410,6037229410,2018,2885,2769,95.980003,2697,72
1400000US06037229420,6037229420,2018,1838,1751,95.269997,1703,48
1400000US06037231100,6037231100,2018,1867,1822,97.589996,1735,87
1400000US06037231220,6037231220,2018,1149,991,86.25,864,127
1400000US06037231302,6037231302,2018,429,410,95.57,392,18
1400000US06037231400,6037231400,2018,139,135,97.120003,126,9
1400000US06037231500,6037231500,2018,392,368,93.879997,325,43
1400000US06037231603,6037231603,2018,1304,1197,91.790001,1158,39
1400000US06037231710,6037231710,2018,511,504,98.629997,492,12
1400000US06037231720,6037231720,2018,238,230,96.639999,213,17
1400000US06037231800,6037231800,2018,712,696,97.75,684,12
1400000US06037232110,6037232110,2018,1300,1246,95.849998,1215,31
1400000US06037232200,6037232200,2018,1532,1453,94.839996,1363,90
1400000US06037232300,6037232300,2018,194,187,96.389999,174,13
1400000US06037232401,6037232401,2018,638,600,94.040001,580,20
1400000US06037232402,6037232402,2018,159,140,88.050003,133,7
1400000US06037232500,6037232500,2018,525,493,93.900002,477,16
1400000US06037234001,6037234001,2018,696,659,94.68,631,28
1400000US06037234002,6037234002,2018,427,414,96.959999,392,22
1400000US06037234301,6037234301,2018,655,617,94.199997,599,18
1400000US06037234501,6037234501,2018,1163,1049,90.199997,998,51
1400000US06037234502,6037234502,2018,656,608,92.68,574,34
1400000US06037234600,6037234600,2018,2423,2051,84.650002,1868,183
1400000US06037234700,6037234700,2018,294,272,92.519997,263,9
1400000US06037234901,6037234901,2018,543,527,97.050003,512,15
1400000US06037234902,6037234902,2018,113,102,90.269997,100,2
1400000US06037235201,6037235201,2018,1207,1131,93.699997,1063,68
1400000US06037236203,6037236203,2018,704,671,95.309998,614,57
1400000US06037236204,6037236204,2018,578,533,92.209999,524,9
1400000US06037236400,6037236400,2018,209,204,97.610001,192,12
1400000US06037237101,6037237101,2018,3300,3081,93.360001,2999,82
1400000US06037237102,6037237102,2018,560,538,96.07,522,16
1400000US06037237300,6037237300,2018,394,288,73.099998,286,2
1400000US06037237500,6037237500,2018,612,573,93.629997,551,22
1400000US06037237600,6037237600,2018,769,743,96.620003,727,16
1400000US06037237800,6037237800,2018,524,503,95.989998,477,26
1400000US06037237900,6037237900,2018,506,448,88.540001,427,21
1400000US06037238000,6037238000,2018,783,745,95.150002,709,36
1400000US06037238200,6037238200,2018,438,402,91.779999,372,30
1400000US06037238320,6037238320,2018,1178,1043,88.540001,943,100
1400000US06037238400,6037238400,2018,405,389,96.050003,380,9
1400000US06037239201,6037239201,2018,1034,1031,99.709999,1027,4
1400000US06037239320,6037239320,2018,1071,1043,97.389999,1016,27
1400000US06037239330,6037239330,2018,828,798,96.379997,774,24
1400000US06037239502,6037239502,2018,3290,3194,97.080002,3095,99
1400000US06037239601,6037239601,2018,1019,994,97.550003,963,31
1400000US06037239802,6037239802,2018,957,925,96.660004,900,25
1400000US06037240010,6037240010,2018,1424,1350,94.800003,1320,30
1400000US06037240020,6037240020,2018,338,320,94.669998,289,31
1400000US06037240200,6037240200,2018,754,732,97.080002,716,16
1400000US06037240301,6037240301,2018,770,754,97.919998,747,7
1400000US06037240302,6037240302,2018,186,180,96.769997,178,2
1400000US06037240401,6037240401,2018,1317,1247,94.68,1218,29
1400000US06037240500,6037240500,2018,1460,1408,96.440002,1336,72
1400000US06037240600,6037240600,2018,1029,1000,97.18,964,36
1400000US06037240700,6037240700,2018,563,539,95.739998,526,13
1400000US06037240902,6037240902,2018,2284,2210,96.760002,2129,81
1400000US06037241001,6037241001,2018,920,899,97.720001,861,38
1400000US06037241110,6037241110,2018,814,780,95.82,753,27
1400000US06037241120,6037241120,2018,440,428,97.269997,420,8
1400000US06037241202,6037241202,2018,588,558,94.900002,541,17
1400000US06037241400,6037241400,2018,606,590,97.360001,570,20
1400000US06037242000,6037242000,2018,385,380,98.699997,372,8
1400000US06037242100,6037242100,2018,984,953,96.849998,917,36
1400000US06037242201,6037242201,2018,850,824,96.940002,806,18
1400000US06037242202,6037242202,2018,857,824,96.150002,792,32
1400000US06037242300,6037242300,2018,706,688,97.449997,661,27
1400000US06037242600,6037242600,2018,633,607,95.889999,595,12
1400000US06037242700,6037242700,2018,1298,1271,97.919998,1241,30
1400000US06037243001,6037243001,2018,501,476,95.010002,442,34
1400000US06037243002,6037243002,2018,468,461,98.5,450,11
1400000US06037243100,6037243100,2018,537,526,97.949997,512,14
1400000US06037262200,6037262200,2018,893,173,19.370001,137,36
1400000US06037262303,6037262303,2018,548,50,9.1199999,48,2
1400000US06037262604,6037262604,2018,523,60,11.47,59,1
1400000US06037262704,6037262704,2018,2961,1016,34.310001,860,156
1400000US06037262706,6037262706,2018,497,41,8.25,33,8
1400000US06037262802,6037262802,2018,2515,547,21.75,499,48
1400000US06037264305,6037264305,2018,634,511,80.599998,452,59
1400000US06037265100,6037265100,2018,652,50,7.6700001,42,8
1400000US06037265601,6037265601,2018,1062,415,39.080002,358,57
1400000US06037267202,6037267202,2018,829,92,11.1,87,5
1400000US06037267300,6037267300,2018,264,199,75.379997,170,29
1400000US06037267404,6037267404,2018,1499,1114,74.32,915,199
1400000US06037267406,6037267406,2018,224,181,80.800003,166,15
1400000US06037267600,6037267600,2018,815,220,26.99,183,37
1400000US06037269000,6037269000,2018,544,192,35.290001,163,29
1400000US06037269100,6037269100,2018,361,113,31.299999,106,7
1400000US06037269300,6037269300,2018,485,45,9.2799997,42,3
1400000US06037269700,6037269700,2018,3033,2159,71.18,1922,237
1400000US06037269907,6037269907,2018,323,247,76.470001,223,24
1400000US06037271200,6037271200,2018,576,149,25.870001,121,28
1400000US06037271300,6037271300,2018,907,686,75.629997,629,57
1400000US06037271400,6037271400,2018,278,127,45.68,112,15
1400000US06037271500,6037271500,2018,559,94,16.82,86,8
1400000US06037271702,6037271702,2018,590,168,28.469999,145,23
1400000US06037271703,6037271703,2018,1353,844,62.380001,732,112
1400000US06037271801,6037271801,2018,277,235,84.839996,206,29
1400000US06037272100,6037272100,2018,994,659,66.300003,607,52
1400000US06037272302,6037272302,2018,24,15,62.5,11,4
1400000US06037273200,6037273200,2018,1200,633,52.75,572,61
1400000US06037273403,6037273403,2018,403,326,80.889999,304,22
1400000US06037273800,6037273800,2018,2599,1523,58.599998,1331,192
1400000US06037274202,6037274202,2018,380,313,82.370003,276,37
1400000US06037275200,6037275200,2018,549,528,96.169998,489,39
1400000US06037275311,6037275311,2018,1501,746,49.700001,671,75
1400000US06037275400,6037275400,2018,287,186,64.809998,162,24
1400000US06037275500,6037275500,2018,724,559,77.209999,525,34
1400000US06037275603,6037275603,2018,266,127,47.740002,96,31
1400000US06037275604,6037275604,2018,569,86,15.11,72,14
1400000US06037275605,6037275605,2018,423,358,84.629997,305,53
1400000US06037276000,6037276000,2018,277,187,67.510002,150,37
1400000US06037276400,6037276400,2018,322,105,32.610001,75,30
1400000US06037276605,6037276605,2018,452,278,61.5,232,46
1400000US06037276607,6037276607,2018,359,254,70.75,212,42
1400000US06037276608,6037276608,2018,1134,784,69.139999,654,130
1400000US06037277000,6037277000,2018,1680,791,47.080002,643,148
1400000US06037277100,6037277100,2018,407,72,17.690001,62,10
1400000US06037291120,6037291120,2018,742,694,93.529999,635,59
1400000US06037291210,6037291210,2018,540,510,94.440002,472,38
1400000US06037291220,6037291220,2018,356,245,68.82,202,43
1400000US06037291300,6037291300,2018,952,739,77.629997,663,76
1400000US06037293204,6037293204,2018,470,399,84.889999,370,29
1400000US06037293302,6037293302,2018,3028,2519,83.190002,2123,396
1400000US06037293304,6037293304,2018,569,536,94.199997,502,34
1400000US06037294110,6037294110,2018,2969,2648,89.190002,2352,296
1400000US06037294200,6037294200,2018,1547,1452,93.860001,1336,116
1400000US06037294302,6037294302,2018,451,292,64.75,215,77
1400000US06037294410,6037294410,2018,309,287,92.879997,278,9
1400000US06037294510,6037294510,2018,812,758,93.349998,715,43
1400000US06037294520,6037294520,2018,494,455,92.110001,422,33
1400000US06037294610,6037294610,2018,1197,1113,92.980003,1012,101
1400000US06037294620,6037294620,2018,745,694,93.150002,618,76
1400000US06037294830,6037294830,2018,559,535,95.709999,515,20
1400000US06037294900,6037294900,2018,582,556,95.529999,527,29
1400000US06037295103,6037295103,2018,815,461,56.560001,381,80
1400000US06037296220,6037296220,2018,959,573,59.75,477,96
1400000US06037296300,6037296300,2018,689,398,57.759998,316,82
1400000US06037296401,6037296401,2018,443,282,63.66,238,44
1400000US06037296500,6037296500,2018,897,835,93.089996,796,39
1400000US06037296600,6037296600,2018,373,345,92.489998,331,14
1400000US06037296901,6037296901,2018,3957,2700,68.230003,2360,340
1400000US06037297110,6037297110,2018,336,258,76.790001,232,26
1400000US06037297120,6037297120,2018,499,466,93.389999,440,26
1400000US06037297202,6037297202,2018,478,384,80.330002,343,41
1400000US06037297400,6037297400,2018,477,219,45.91,181,38
1400000US06037297501,6037297501,2018,351,125,35.610001,104,21
1400000US06037297601,6037297601,2018,57,46,80.699997,40,6
1400000US06037297602,6037297602,2018,343,215,62.68,179,36
1400000US06037300200,6037300200,2018,2686,589,21.93,475,114
1400000US06037300301,6037300301,2018,2183,826,37.84,700,126
1400000US06037300400,6037300400,2018,502,132,26.290001,107,25
1400000US06037300501,6037300501,2018,3059,782,25.559999,662,120
1400000US06037300602,6037300602,2018,661,168,25.42,138,30
1400000US06037300800,6037300800,2018,792,245,30.93,210,35
1400000US06037300902,6037300902,2018,520,210,40.380001,183,27
1400000US06037301000,6037301000,2018,1305,824,63.139999,734,90
1400000US06037301206,6037301206,2018,3892,2174,55.860001,1793,381
1400000US06037301400,6037301400,2018,830,510,61.450001,422,88
1400000US06037301502,6037301502,2018,669,514,76.830002,430,84
1400000US06037301602,6037301602,2018,634,112,17.67,94,18
1400000US06037301801,6037301801,2018,548,409,74.639999,340,69
1400000US06037301902,6037301902,2018,929,616,66.309998,524,92
1400000US06037302002,6037302002,2018,120,89,74.169998,75,14
1400000US06037302004,6037302004,2018,462,380,82.25,323,57
1400000US06037302104,6037302104,2018,2173,1515,69.720001,1309,206
1400000US06037302302,6037302302,2018,937,590,62.970001,492,98
1400000US06037302504,6037302504,2018,2264,1847,81.580002,1653,194
1400000US06037302505,6037302505,2018,384,325,84.639999,288,37
1400000US06037310201,6037310201,2018,606,223,36.799999,201,22
1400000US06037310300,6037310300,2018,2158,750,34.75,639,111
1400000US06037310601,6037310601,2018,462,272,58.869999,232,40
1400000US06037310602,6037310602,2018,2525,1044,41.349998,929,115
1400000US06037310703,6037310703,2018,733,361,49.25,334,27
1400000US06037310705,6037310705,2018,21,17,80.949997,16,1
1400000US06037310800,6037310800,2018,2953,1022,34.610001,875,147
1400000US06037310900,6037310900,2018,683,182,26.65,161,21
1400000US06037311000,6037311000,2018,959,404,42.130001,338,66
1400000US06037311100,6037311100,2018,970,406,41.860001,327,79
1400000US06037311200,6037311200,2018,92,17,18.48,15,2
1400000US06037311500,6037311500,2018,1240,237,19.110001,209,28
1400000US06037311700,6037311700,2018,1062,397,37.380001,339,58
1400000US06037311802,6037311802,2018,468,205,43.799999,171,34
1400000US06037320101,6037320101,2018,521,454,87.139999,405,49
1400000US06037320102,6037320102,2018,1790,1497,83.629997,1341,156
1400000US06037320201,6037320201,2018,1698,1468,86.449997,1351,117
1400000US06037320202,6037320202,2018,563,504,89.519997,443,61
1400000US06037320300,6037320300,2018,1949,1708,87.629997,1570,138
1400000US06037400205,6037400205,2018,44,44,100,44,0
1400000US06037400208,6037400208,2018,574,87,15.16,78,9
1400000US06037400304,6037400304,2018,941,470,49.950001,410,60
1400000US06037400402,6037400402,2018,2437,657,26.959999,555,102
1400000US06037400403,6037400403,2018,36,36,100,36,0
1400000US06037400404,6037400404,2018,627,114,18.18,97,17
1400000US06037400501,6037400501,2018,909,194,21.34,163,31
1400000US06037400602,6037400602,2018,635,444,69.919998,395,49
1400000US06037400605,6037400605,2018,271,232,85.610001,205,27
1400000US06037400801,6037400801,2018,2094,911,43.509998,761,150
1400000US06037401001,6037401001,2018,598,128,21.4,107,21
1400000US06037401202,6037401202,2018,908,386,42.509998,305,81
1400000US06037401203,6037401203,2018,105,51,48.57,46,5
1400000US06037401311,6037401311,2018,1198,372,31.049999,298,74
1400000US06037401312,6037401312,2018,2265,922,40.709999,755,167
1400000US06037401601,6037401601,2018,520,133,25.58,120,13
1400000US06037401602,6037401602,2018,2652,1018,38.389999,858,160
1400000US06037401705,6037401705,2018,552,282,51.09,253,29
1400000US06037401707,6037401707,2018,359,323,89.970001,294,29
1400000US06037401801,6037401801,2018,663,152,22.93,134,18
1400000US06037401802,6037401802,2018,3041,974,32.029999,828,146
1400000US06037401902,6037401902,2018,1989,783,39.369999,648,135
1400000US06037402001,6037402001,2018,336,255,75.889999,211,44
1400000US06037402002,6037402002,2018,367,214,58.310001,175,39
1400000US06037402101,6037402101,2018,319,302,94.669998,275,27
1400000US06037402102,6037402102,2018,2100,1858,88.480003,1650,208
1400000US06037402200,6037402200,2018,288,250,86.809998,227,23
1400000US06037402301,6037402301,2018,1303,1179,90.480003,1076,103
1400000US06037402303,6037402303,2018,369,354,95.93,335,19
1400000US06037402403,6037402403,2018,913,539,59.040001,439,100
1400000US06037402405,6037402405,2018,917,829,90.400002,734,95
1400000US06037402406,6037402406,2018,1075,1018,94.699997,928,90
1400000US06037402501,6037402501,2018,1201,1181,98.330002,1121,60
1400000US06037402503,6037402503,2018,954,905,94.860001,837,68
1400000US06037402504,6037402504,2018,526,506,96.199997,459,47
1400000US06037402601,6037402601,2018,609,590,96.879997,547,43
1400000US06037402702,6037402702,2018,1037,937,90.360001,869,68
1400000US06037402703,6037402703,2018,302,269,89.07,231,38
1400000US06037402705,6037402705,2018,582,555,95.360001,525,30
1400000US06037402706,6037402706,2018,248,239,96.370003,220,19
1400000US06037402902,6037402902,2018,646,605,93.650002,546,59
1400000US06037402903,6037402903,2018,1618,1538,95.059998,1409,129
1400000US06037403000,6037403000,2018,3101,2849,91.870003,2549,300
1400000US06037403316,6037403316,2018,1003,612,61.02,513,99
1400000US06037403317,6037403317,2018,2032,1181,58.119999,965,216
1400000US06037403318,6037403318,2018,530,375,70.75,330,45
1400000US06037403320,6037403320,2018,361,147,40.720001,126,21
1400000US06037403321,6037403321,2018,320,207,64.690002,182,25
1400000US06037403323,6037403323,2018,1759,367,20.860001,328,39
1400000US06037403324,6037403324,2018,652,135,20.709999,116,19
1400000US06037403325,6037403325,2018,4145,810,19.540001,740,70
1400000US06037403326,6037403326,2018,684,190,27.780001,173,17
1400000US06037403327,6037403327,2018,327,206,63,179,27
1400000US06037403401,6037403401,2018,489,133,27.200001,120,13
1400000US06037403402,6037403402,2018,3037,724,23.84,640,84
1400000US06037403404,6037403404,2018,1286,311,24.18,274,37
1400000US06037403407,6037403407,2018,605,92,15.21,79,13
1400000US06037403408,6037403408,2018,1075,501,46.599998,404,97
1400000US06037403409,6037403409,2018,539,129,23.93,120,9
1400000US06037403601,6037403601,2018,885,541,61.130001,459,82
1400000US06037403702,6037403702,2018,1906,1031,54.09,902,129
1400000US06037403703,6037403703,2018,396,254,64.139999,224,30
1400000US06037403722,6037403722,2018,735,432,58.779999,372,60
1400000US06037403801,6037403801,2018,1156,816,70.589996,716,100
1400000US06037403901,6037403901,2018,49,27,55.099998,24,3
1400000US06037403902,6037403902,2018,431,251,58.240002,224,27
1400000US06037404000,6037404000,2018,756,648,85.709999,580,68
1400000US06037404100,6037404100,2018,436,394,90.370003,355,39
1400000US06037404201,6037404201,2018,2080,1729,83.129997,1523,206
1400000US06037404203,6037404203,2018,210,175,83.330002,153,22
1400000US06037404401,6037404401,2018,699,571,81.690002,498,73
1400000US06037404402,6037404402,2018,696,608,87.360001,546,62
1400000US06037404503,6037404503,2018,257,231,89.879997,215,16
1400000US06037404504,6037404504,2018,448,405,90.400002,374,31
1400000US06037404600,6037404600,2018,1808,1378,76.220001,1202,176
1400000US06037404701,6037404701,2018,878,808,92.029999,732,76
1400000US06037404702,6037404702,2018,679,584,86.010002,539,45
1400000US06037404804,6037404804,2018,2669,2347,87.940002,2091,256
1400000US06037404805,6037404805,2018,488,449,92.010002,411,38
1400000US06037404806,6037404806,2018,1040,913,87.790001,841,72
1400000US06037404901,6037404901,2018,541,448,82.809998,407,41
1400000US06037404903,6037404903,2018,499,448,89.779999,393,55
1400000US06037405001,6037405001,2018,947,815,86.059998,737,78
1400000US06037405002,6037405002,2018,342,332,97.080002,295,37
1400000US06037405101,6037405101,2018,1645,1451,88.209999,1302,149
1400000US06037405201,6037405201,2018,2285,1986,86.910004,1807,179
1400000US06037405202,6037405202,2018,679,610,89.839996,559,51
1400000US06037405302,6037405302,2018,509,400,78.589996,356,44
1400000US06037405400,6037405400,2018,279,213,76.339996,190,23
1400000US06037405600,6037405600,2018,1036,750,72.389999,604,146
1400000US06037405701,6037405701,2018,902,684,75.830002,564,120
1400000US06037405702,6037405702,2018,1251,904,72.260002,760,144
1400000US06037405800,6037405800,2018,1731,1362,78.68,1213,149
1400000US06037406000,6037406000,2018,1895,1392,73.459999,1152,240
1400000US06037406103,6037406103,2018,600,425,70.830002,361,64
1400000US06037406201,6037406201,2018,1315,963,73.230003,798,165
1400000US06037406300,6037406300,2018,2242,1140,50.849998,933,207
1400000US06037406413,6037406413,2018,1305,829,63.52,699,130
1400000US06037406601,6037406601,2018,3755,2571,68.470001,2188,383
1400000US06037406602,6037406602,2018,400,309,77.25,273,36
1400000US06037406701,6037406701,2018,355,288,81.129997,253,35
1400000US06037406702,6037406702,2018,218,177,81.190002,157,20
1400000US06037406801,6037406801,2018,1899,1347,70.93,1151,196
1400000US06037406903,6037406903,2018,2262,1533,67.769997,1260,273
1400000US06037407001,6037407001,2018,387,352,90.959999,320,32
1400000US06037407002,6037407002,2018,624,567,90.870003,518,49
1400000US06037407101,6037407101,2018,1823,1582,86.779999,1464,118
1400000US06037407201,6037407201,2018,341,302,88.559998,272,30
1400000US06037407301,6037407301,2018,344,309,89.830002,286,23
1400000US06037407302,6037407302,2018,1160,1062,91.550003,940,122
1400000US06037407501,6037407501,2018,898,725,80.730003,628,97
1400000US06037407502,6037407502,2018,626,524,83.709999,485,39
1400000US06037407602,6037407602,2018,621,557,89.690002,503,54
1400000US06037407701,6037407701,2018,493,479,97.160004,461,18
1400000US06037407702,6037407702,2018,1487,1294,87.019997,1183,111
1400000US06037407801,6037407801,2018,567,474,83.599998,430,44
1400000US06037407802,6037407802,2018,1348,1127,83.610001,1006,121
1400000US06037407901,6037407901,2018,542,434,80.07,391,43
1400000US06037408003,6037408003,2018,139,99,71.220001,91,8
1400000US06037408135,6037408135,2018,590,547,92.709999,507,40
1400000US06037408136,6037408136,2018,336,277,82.440002,246,31
1400000US06037408137,6037408137,2018,776,651,83.889999,550,101
1400000US06037408138,6037408138,2018,423,407,96.220001,377,30
1400000US06037408139,6037408139,2018,474,447,94.300003,398,49
1400000US06037408140,6037408140,2018,614,577,93.970001,521,56
1400000US06037408141,6037408141,2018,2393,2112,88.260002,1894,218
1400000US06037408212,6037408212,2018,657,395,60.119999,334,61
1400000US06037408213,6037408213,2018,371,333,89.760002,302,31
1400000US06037408301,6037408301,2018,460,433,94.129997,400,33
1400000US06037408302,6037408302,2018,644,376,58.389999,316,60
1400000US06037408401,6037408401,2018,11,6,54.549999,6,0
1400000US06037408402,6037408402,2018,1023,816,79.769997,702,114
1400000US06037408503,6037408503,2018,939,463,49.310001,391,72
1400000US06037408504,6037408504,2018,616,364,59.09,313,51
1400000US06037408505,6037408505,2018,2022,1407,69.580002,1206,201
1400000US06037408623,6037408623,2018,1976,1082,54.759998,895,187
1400000US06037408624,6037408624,2018,251,194,77.290001,168,26
1400000US06037408625,6037408625,2018,1648,709,43.02,594,115
1400000US06037408631,6037408631,2018,604,453,75,406,47
1400000US06037408705,6037408705,2018,3034,1908,62.889999,1638,270
1400000US06037408707,6037408707,2018,882,216,24.49,203,13
1400000US06037408722,6037408722,2018,648,354,54.630001,309,45
1400000US06037408724,6037408724,2018,495,462,93.330002,422,40
1400000US06037408725,6037408725,2018,725,513,70.760002,447,66
1400000US06037408900,6037408900,2018,1762,741,42.049999,611,130
1400000US06037409000,6037409000,2018,538,488,90.709999,443,45
1400000US06037409100,6037409100,2018,154,132,85.709999,121,11
1400000US06037430003,6037430003,2018,346,208,60.119999,165,43
1400000US06037430005,6037430005,2018,355,295,83.099998,264,31
1400000US06037430101,6037430101,2018,1967,1220,62.02,1019,201
1400000US06037430102,6037430102,2018,361,313,86.699997,287,26
1400000US06037430200,6037430200,2018,757,397,52.439999,307,90
1400000US06037430302,6037430302,2018,523,239,45.700001,203,36
1400000US06037430400,6037430400,2018,1436,304,21.17,249,55
1400000US06037430502,6037430502,2018,1197,270,22.559999,226,44
1400000US06037430701,6037430701,2018,623,166,26.65,147,19
1400000US06037430721,6037430721,2018,3225,845,26.200001,693,152
1400000US06037430801,6037430801,2018,845,225,26.629999,195,30
1400000US06037430802,6037430802,2018,1325,385,29.059999,321,64
1400000US06037431002,6037431002,2018,562,370,65.839996,335,35
1400000US06037431003,6037431003,2018,1639,850,51.860001,744,106
1400000US06037431004,6037431004,2018,1753,1091,62.240002,978,113
1400000US06037431100,6037431100,2018,527,384,72.870003,343,41
1400000US06037431200,6037431200,2018,394,353,89.589996,323,30
1400000US06037431400,6037431400,2018,410,297,72.440002,256,41
1400000US06037431501,6037431501,2018,375,269,71.730003,234,35
1400000US06037431502,6037431502,2018,714,584,81.790001,525,59
1400000US06037431600,6037431600,2018,465,136,29.25,112,24
1400000US06037431701,6037431701,2018,1386,414,29.870001,352,62
1400000US06037431800,6037431800,2018,1972,891,45.18,711,180
1400000US06037431900,6037431900,2018,1012,435,42.98,351,84
1400000US06037432002,6037432002,2018,504,257,50.990002,201,56
1400000US06037432102,6037432102,2018,589,246,41.77,204,42
1400000US06037432201,6037432201,2018,477,346,72.540001,272,74
1400000US06037432202,6037432202,2018,2684,2207,82.230003,1854,353
1400000US06037432300,6037432300,2018,899,810,90.099998,746,64
1400000US06037432401,6037432401,2018,2940,2573,87.519997,2265,308
1400000US06037432402,6037432402,2018,503,474,94.230003,431,43
1400000US06037432501,6037432501,2018,386,337,87.309998,302,35
1400000US06037432602,6037432602,2018,1333,1204,90.32,1126,78
1400000US06037432801,6037432801,2018,571,558,97.720001,538,20
1400000US06037432902,6037432902,2018,403,339,84.120003,280,59
1400000US06037433103,6037433103,2018,401,387,96.510002,361,26
1400000US06037433200,6037433200,2018,2999,2860,95.370003,2655,205
1400000US06037433302,6037433302,2018,812,778,95.809998,734,44
1400000US06037433305,6037433305,2018,557,491,88.150002,469,22
1400000US06037433306,6037433306,2018,407,390,95.82,366,24
1400000US06037433307,6037433307,2018,681,613,90.010002,570,43
1400000US06037433505,6037433505,2018,1269,1240,97.709999,1190,50
1400000US06037433803,6037433803,2018,1825,1631,89.370003,1450,181
1400000US06037433804,6037433804,2018,1117,1015,90.870003,952,63
1400000US06037433901,6037433901,2018,474,437,92.190002,423,14
1400000US06037433903,6037433903,2018,1290,1176,91.160004,1138,38
1400000US06037434001,6037434001,2018,1307,1222,93.5,1113,109
1400000US06037434003,6037434003,2018,1235,1114,90.199997,1058,56
1400000US06037434100,6037434100,2018,501,421,84.029999,354,67
1400000US06037460002,6037460002,2018,595,226,37.98,186,40
1400000US06037460101,6037460101,2018,418,67,16.030001,58,9
1400000US06037460200,6037460200,2018,172,113,65.699997,88,25
1400000US06037460301,6037460301,2018,507,164,32.349998,139,25
1400000US06037460302,6037460302,2018,673,306,45.470001,265,41
1400000US06037460501,6037460501,2018,752,32,4.2600002,30,2
1400000US06037460502,6037460502,2018,650,19,2.9200001,18,1
1400000US06037460601,6037460601,2018,654,33,5.0500002,33,0
1400000US06037460700,6037460700,2018,2044,114,5.5799999,106,8
1400000US06037460900,6037460900,2018,975,747,76.620003,703,44
1400000US06037461000,6037461000,2018,588,406,69.050003,368,38
1400000US06037461100,6037461100,2018,246,168,68.290001,163,5
1400000US06037461200,6037461200,2018,510,353,69.220001,334,19
1400000US06037461300,6037461300,2018,395,255,64.559998,207,48
1400000US06037461400,6037461400,2018,480,387,80.629997,349,38
1400000US06037461502,6037461502,2018,988,795,80.470001,773,22
1400000US06037461700,6037461700,2018,298,222,74.5,214,8
1400000US06037462100,6037462100,2018,424,343,80.900002,328,15
1400000US06037462500,6037462500,2018,2275,1371,60.259998,1177,194
1400000US06037462600,6037462600,2018,1968,1175,59.709999,1021,154
1400000US06037462700,6037462700,2018,372,326,87.629997,291,35
1400000US06037462900,6037462900,2018,137,125,91.239998,121,4
1400000US06037463000,6037463000,2018,1794,1214,67.669998,1098,116
1400000US06037463200,6037463200,2018,1119,809,72.300003,715,94
1400000US06037463300,6037463300,2018,592,261,44.09,198,63
1400000US06037463601,6037463601,2018,1177,771,65.510002,701,70
1400000US06037463800,6037463800,2018,449,148,32.959999,130,18
1400000US06037464000,6037464000,2018,1067,643,60.259998,588,55
1400000US06037464101,6037464101,2018,1311,73,5.5700002,69,4
1400000US06037464200,6037464200,2018,1088,108,9.9300003,101,7
1400000US06037480002,6037480002,2018,904,148,16.370001,118,30
1400000US06037480012,6037480012,2018,1645,677,41.16,533,144
1400000US06037480201,6037480201,2018,357,173,48.459999,148,25
1400000US06037480202,6037480202,2018,487,256,52.57,210,46
1400000US06037480302,6037480302,2018,442,312,70.589996,276,36
1400000US06037480304,6037480304,2018,3015,2221,73.669998,1854,367
1400000US06037480400,6037480400,2018,1688,1106,65.519997,914,192
1400000US06037480500,6037480500,2018,1890,345,18.25,308,37
1400000US06037480702,6037480702,2018,664,92,13.86,79,13
1400000US06037480703,6037480703,2018,702,115,16.379999,102,13
1400000US06037480704,6037480704,2018,1456,314,21.57,260,54
1400000US06037480803,6037480803,2018,439,313,71.300003,257,56
1400000US06037480804,6037480804,2018,733,500,68.209999,419,81
1400000US06037480901,6037480901,2018,178,131,73.599998,116,15
1400000US06037480903,6037480903,2018,711,494,69.480003,409,85
1400000US06037481101,6037481101,2018,1582,1133,71.620003,988,145
1400000US06037481102,6037481102,2018,54,43,79.629997,36,7
1400000US06037481103,6037481103,2018,2124,1703,80.18,1512,191
1400000US06037481203,6037481203,2018,1554,1030,66.279999,886,144
1400000US06037481300,6037481300,2018,563,430,76.379997,349,81
1400000US06037481401,6037481401,2018,575,424,73.739998,348,76
1400000US06037481403,6037481403,2018,376,321,85.370003,301,20
1400000US06037481404,6037481404,2018,1729,1035,59.860001,873,162
1400000US06037481500,6037481500,2018,2266,1341,59.18,1115,226
1400000US06037481606,6037481606,2018,828,642,77.540001,534,108
1400000US06037481901,6037481901,2018,555,382,68.830002,310,72
1400000US06037482001,6037482001,2018,972,468,48.150002,364,104
1400000US06037482002,6037482002,2018,941,413,43.889999,331,82
1400000US06037482101,6037482101,2018,856,661,77.220001,554,107
1400000US06037482102,6037482102,2018,806,440,54.59,349,91
1400000US06037482202,6037482202,2018,493,348,70.589996,311,37
1400000US06037482304,6037482304,2018,500,425,85,392,33
1400000US06037482401,6037482401,2018,386,332,86.010002,305,27
1400000US06037482403,6037482403,2018,1298,1124,86.589996,1041,83
1400000US06037482502,6037482502,2018,1194,972,81.410004,908,64
1400000US06037482522,6037482522,2018,371,227,61.189999,192,35
1400000US06037482600,6037482600,2018,363,248,68.32,227,21
1400000US06037482701,6037482701,2018,507,371,73.18,324,47
1400000US06037482801,6037482801,2018,908,674,74.230003,577,97
1400000US06037500202,6037500202,2018,3881,2049,52.799999,1595,454
1400000US06037500203,6037500203,2018,538,122,22.68,107,15
1400000US06037500300,6037500300,2018,450,295,65.559998,258,37
1400000US06037500402,6037500402,2018,689,510,74.019997,468,42
1400000US06037500404,6037500404,2018,383,286,74.669998,245,41
1400000US06037500600,6037500600,2018,781,614,78.620003,555,59
1400000US06037500700,6037500700,2018,461,329,71.370003,279,50
1400000US06037500800,6037500800,2018,2911,1991,68.400002,1725,266
1400000US06037500900,6037500900,2018,536,410,76.489998,375,35
1400000US06037501001,6037501001,2018,334,287,85.93,254,33
1400000US06037501002,6037501002,2018,1240,1006,81.129997,884,122
1400000US06037501200,6037501200,2018,379,281,74.139999,255,26
1400000US06037501302,6037501302,2018,1568,1183,75.449997,1020,163
1400000US06037501400,6037501400,2018,1873,1421,75.870003,1241,180
1400000US06037501600,6037501600,2018,431,315,73.089996,281,34
1400000US06037501700,6037501700,2018,718,234,32.59,181,53
1400000US06037501804,6037501804,2018,413,364,88.139999,336,28
1400000US06037502003,6037502003,2018,407,356,87.470001,314,42
1400000US06037502005,6037502005,2018,604,435,72.019997,373,62
1400000US06037502200,6037502200,2018,536,401,74.809998,355,46
1400000US06037502303,6037502303,2018,2483,2149,86.550003,1874,275
1400000US06037502401,6037502401,2018,1369,998,72.900002,860,138
1400000US06037502500,6037502500,2018,158,105,66.459999,89,16
1400000US06037502602,6037502602,2018,407,307,75.43,274,33
1400000US06037502603,6037502603,2018,624,438,70.190002,371,67
1400000US06037502604,6037502604,2018,438,324,73.970001,258,66
1400000US06037502700,6037502700,2018,832,602,72.360001,474,128
1400000US06037502801,6037502801,2018,3664,2678,73.089996,1951,727
1400000US06037503103,6037503103,2018,509,463,90.959999,428,35
1400000US06037503105,6037503105,2018,599,547,91.32,478,69
1400000US06037503201,6037503201,2018,383,270,70.5,226,44
1400000US06037503202,6037503202,2018,368,323,87.769997,269,54
1400000US06037503302,6037503302,2018,3349,2473,73.839996,2085,388
1400000US06037503402,6037503402,2018,595,187,31.43,143,44
1400000US06037503501,6037503501,2018,1055,641,60.759998,539,102
1400000US06037503502,6037503502,2018,705,462,65.529999,397,65
1400000US06037503602,6037503602,2018,2505,1324,52.849998,1098,226
1400000US06037503701,6037503701,2018,1781,775,43.509998,609,166
1400000US06037503705,6037503705,2018,259,129,49.810001,111,18
1400000US06037503801,6037503801,2018,1071,501,46.779999,447,54
1400000US06037503802,6037503802,2018,461,227,49.240002,186,41
1400000US06037503902,6037503902,2018,575,254,44.169998,200,54
1400000US06037504002,6037504002,2018,1467,759,51.740002,629,130
1400000US06037504101,6037504101,2018,335,265,79.099998,239,26
1400000US06037504200,6037504200,2018,1806,1562,86.489998,1418,144
1400000US06037530005,6037530005,2018,2672,1961,73.389999,1681,280
1400000US06037530007,6037530007,2018,1942,1472,75.800003,1325,147
1400000US06037530101,6037530101,2018,383,316,82.510002,298,18
1400000US06037530102,6037530102,2018,4368,3675,84.129997,3308,367
1400000US06037530202,6037530202,2018,771,696,90.269997,654,42
1400000US06037530203,6037530203,2018,589,470,79.800003,431,39
1400000US06037530301,6037530301,2018,3553,3307,93.080002,3039,268
1400000US06037530400,6037530400,2018,1800,1589,88.279999,1385,204
1400000US06037530500,6037530500,2018,698,648,92.839996,598,50
1400000US06037530603,6037530603,2018,699,580,82.980003,520,60
1400000US06037530700,6037530700,2018,571,491,85.989998,428,63
1400000US06037530801,6037530801,2018,434,413,95.160004,398,15
1400000US06037530902,6037530902,2018,675,641,94.959999,607,34
1400000US06037531000,6037531000,2018,2932,2781,94.849998,2606,175
1400000US06037531101,6037531101,2018,3090,2616,84.660004,2456,160
1400000US06037531102,6037531102,2018,1022,987,96.580002,935,52
1400000US06037531201,6037531201,2018,818,772,94.379997,737,35
1400000US06037531202,6037531202,2018,164,158,96.339996,154,4
1400000US06037531302,6037531302,2018,1257,1180,93.870003,1071,109
1400000US06037531502,6037531502,2018,983,933,94.910004,878,55
1400000US06037531503,6037531503,2018,591,562,95.089996,535,27
1400000US06037531603,6037531603,2018,1459,1390,95.269997,1272,118
1400000US06037531604,6037531604,2018,122,118,96.720001,116,2
1400000US06037531701,6037531701,2018,557,491,88.150002,429,62
1400000US06037531702,6037531702,2018,559,480,85.870003,468,12
1400000US06037531800,6037531800,2018,791,642,81.160004,621,21
1400000US06037531902,6037531902,2018,515,432,83.879997,408,24
1400000US06037532002,6037532002,2018,541,422,78,369,53
1400000US06037532101,6037532101,2018,55,31,56.360001,31,0
1400000US06037532102,6037532102,2018,890,777,87.300003,739,38
1400000US06037532200,6037532200,2018,280,204,72.860001,197,7
1400000US06037532302,6037532302,2018,462,358,77.489998,333,25
1400000US06037532303,6037532303,2018,804,643,79.980003,546,97
1400000US06037532500,6037532500,2018,3144,2969,94.43,2755,214
1400000US06037532605,6037532605,2018,420,375,89.290001,339,36
1400000US06037532607,6037532607,2018,2056,1926,93.68,1788,138
1400000US06037532700,6037532700,2018,925,902,97.510002,857,45
1400000US06037532800,6037532800,2018,2704,2606,96.379997,2525,81
1400000US06037532900,6037532900,2018,1911,1853,96.959999,1788,65
1400000US06037533103,6037533103,2018,2961,2800,94.559998,2613,187
1400000US06037533108,6037533108,2018,2566,2457,95.75,2293,164
1400000US06037533201,6037533201,2018,558,535,95.879997,489,46
1400000US06037533204,6037533204,2018,583,532,91.25,502,30
1400000US06037533402,6037533402,2018,1524,1449,95.080002,1346,103
1400000US06037533403,6037533403,2018,1686,1576,93.480003,1429,147
1400000US06037533501,6037533501,2018,1481,1403,94.730003,1290,113
1400000US06037533504,6037533504,2018,797,737,92.470001,676,61
1400000US06037533601,6037533601,2018,951,890,93.589996,809,81
1400000US06037533602,6037533602,2018,2564,2352,91.730003,2189,163
1400000US06037533603,6037533603,2018,2530,2376,93.910004,2135,241
1400000US06037533701,6037533701,2018,1048,957,91.32,834,123
1400000US06037533703,6037533703,2018,605,574,94.879997,522,52
1400000US06037533804,6037533804,2018,696,624,89.660004,581,43
1400000US06037533901,6037533901,2018,3595,3169,88.150002,2909,260
1400000US06037533902,6037533902,2018,710,570,80.279999,550,20
1400000US06037534001,6037534001,2018,855,770,90.059998,716,54
1400000US06037534002,6037534002,2018,894,724,80.980003,681,43
1400000US06037534102,6037534102,2018,1157,1028,88.849998,981,47
1400000US06037534201,6037534201,2018,993,857,86.300003,824,33
1400000US06037534302,6037534302,2018,476,452,94.959999,431,21
1400000US06037534404,6037534404,2018,1324,1248,94.260002,1161,87
1400000US06037534405,6037534405,2018,1743,1641,94.150002,1534,107
1400000US06037534406,6037534406,2018,1287,1196,92.93,1117,79
1400000US06037534501,6037534501,2018,995,922,92.660004,839,83
1400000US06037534803,6037534803,2018,692,656,94.800003,602,54
1400000US06037534804,6037534804,2018,456,414,90.790001,376,38
1400000US06037534900,6037534900,2018,2550,2412,94.589996,2169,243
1400000US06037535001,6037535001,2018,1675,1613,96.300003,1568,45
1400000US06037535101,6037535101,2018,2529,2470,97.669998,2366,104
1400000US06037535102,6037535102,2018,717,694,96.790001,674,20
1400000US06037535300,6037535300,2018,1224,1169,95.510002,1107,62
1400000US06037535501,6037535501,2018,589,553,93.889999,520,33
1400000US06037535603,6037535603,2018,540,502,92.959999,449,53
1400000US06037535604,6037535604,2018,558,530,94.980003,499,31
1400000US06037535605,6037535605,2018,918,835,90.959999,747,88
1400000US06037535607,6037535607,2018,4005,3759,93.860001,3420,339
1400000US06037535701,6037535701,2018,674,636,94.360001,595,41
1400000US06037535702,6037535702,2018,3445,3161,91.760002,2828,333
1400000US06037535803,6037535803,2018,416,387,93.029999,357,30
1400000US06037535901,6037535901,2018,1648,1457,88.410004,1276,181
1400000US06037536000,6037536000,2018,2761,2571,93.120003,2282,289
1400000US06037536103,6037536103,2018,628,575,91.559998,498,77
1400000US06037536104,6037536104,2018,1832,1622,88.540001,1409,213
1400000US06037536201,6037536201,2018,1023,916,89.540001,813,103
1400000US06037540000,6037540000,2018,2703,2382,88.120003,2216,166
1400000US06037540101,6037540101,2018,3241,2745,84.699997,2516,229
1400000US06037540102,6037540102,2018,6,4,66.669998,4,0
1400000US06037540202,6037540202,2018,1947,1841,94.559998,1699,142
1400000US06037540203,6037540203,2018,618,570,92.230003,522,48
1400000US06037540300,6037540300,2018,478,466,97.489998,438,28
1400000US06037540400,6037540400,2018,344,333,96.800003,324,9
1400000US06037540502,6037540502,2018,744,612,82.260002,594,18
1400000US06037540600,6037540600,2018,582,494,84.879997,477,17
1400000US06037540700,6037540700,2018,2420,2157,89.129997,1965,192
1400000US06037540800,6037540800,2018,1543,1409,91.32,1335,74
1400000US06037540901,6037540901,2018,731,685,93.709999,639,46
1400000US06037540902,6037540902,2018,218,202,92.660004,190,12
1400000US06037541003,6037541003,2018,552,455,82.43,386,69
1400000US06037541100,6037541100,2018,439,357,81.32,345,12
1400000US06037541200,6037541200,2018,905,801,88.510002,768,33
1400000US06037541300,6037541300,2018,1307,1127,86.230003,1073,54
1400000US06037541401,6037541401,2018,530,458,86.419998,432,26
1400000US06037541500,6037541500,2018,837,774,92.470001,732,42
1400000US06037541603,6037541603,2018,893,854,95.629997,833,21
1400000US06037541605,6037541605,2018,633,524,82.779999,509,15
1400000US06037541700,6037541700,2018,3509,3289,93.730003,3047,242
1400000US06037541802,6037541802,2018,658,605,91.949997,551,54
1400000US06037542000,6037542000,2018,1605,1367,85.169998,1319,48
1400000US06037542104,6037542104,2018,632,571,90.349998,551,20
1400000US06037542106,6037542106,2018,3040,2666,87.699997,2553,113
1400000US06037542200,6037542200,2018,927,770,83.059998,741,29
1400000US06037542401,6037542401,2018,640,604,94.379997,556,48
1400000US06037542402,6037542402,2018,2912,2587,88.839996,2471,116
1400000US06037542601,6037542601,2018,533,432,81.050003,418,14
1400000US06037542700,6037542700,2018,1379,1218,88.32,1178,40
1400000US06037542800,6037542800,2018,760,639,84.080002,612,27
1400000US06037542900,6037542900,2018,723,568,78.559998,528,40
1400000US06037543000,6037543000,2018,937,789,84.199997,749,40
1400000US06037543100,6037543100,2018,933,773,82.849998,728,45
1400000US06037543201,6037543201,2018,661,416,62.93,412,4
1400000US06037543203,6037543203,2018,311,288,92.599998,278,10
1400000US06037543304,6037543304,2018,244,205,84.019997,176,29
1400000US06037543306,6037543306,2018,347,251,72.330002,204,47
1400000US06037543321,6037543321,2018,662,304,45.919998,233,71
1400000US06037543322,6037543322,2018,1424,1163,81.669998,1040,123
1400000US06037543400,6037543400,2018,305,255,83.610001,208,47
1400000US06037543501,6037543501,2018,1683,1297,77.059998,1110,187
1400000US06037543503,6037543503,2018,1044,902,86.400002,818,84
1400000US06037543601,6037543601,2018,922,666,72.230003,547,119
1400000US06037543607,6037543607,2018,403,281,69.730003,219,62
1400000US06037543701,6037543701,2018,3095,2236,72.25,1894,342
1400000US06037543705,6037543705,2018,494,450,91.089996,412,38
1400000US06037543801,6037543801,2018,678,501,73.889999,421,80
1400000US06037543903,6037543903,2018,1374,1045,76.059998,888,157
1400000US06037544001,6037544001,2018,477,407,85.32,353,54
1400000US06037544002,6037544002,2018,854,690,80.800003,589,101
1400000US06037550101,6037550101,2018,307,231,75.239998,170,61
1400000US06037550201,6037550201,2018,261,203,77.779999,168,35
1400000US06037550202,6037550202,2018,377,291,77.190002,229,62
1400000US06037550301,6037550301,2018,466,316,67.809998,230,86
1400000US06037550501,6037550501,2018,683,499,73.059998,407,92
1400000US06037550602,6037550602,2018,723,407,56.290001,338,69
1400000US06037550700,6037550700,2018,2075,1341,64.629997,1019,322
1400000US06037550801,6037550801,2018,790,563,71.269997,459,104
1400000US06037550901,6037550901,2018,3979,2525,63.459999,1948,577
1400000US06037551001,6037551001,2018,782,467,59.720001,365,102
1400000US06037551002,6037551002,2018,1376,891,64.75,707,184
1400000US06037551101,6037551101,2018,581,497,85.540001,448,49
1400000US06037551102,6037551102,2018,234,160,68.379997,150,10
1400000US06037551201,6037551201,2018,519,400,77.07,335,65
1400000US06037551203,6037551203,2018,1236,979,79.209999,788,191
1400000US06037551204,6037551204,2018,584,441,75.510002,361,80
1400000US06037551300,6037551300,2018,3592,2384,66.370003,1809,575
1400000US06037551402,6037551402,2018,700,493,70.43,382,111
1400000US06037551501,6037551501,2018,2209,1678,75.959999,1322,356
1400000US06037551700,6037551700,2018,402,330,82.089996,279,51
1400000US06037551801,6037551801,2018,876,434,49.540001,371,63
1400000US06037551802,6037551802,2018,794,564,71.029999,460,104
1400000US06037551900,6037551900,2018,391,340,86.959999,293,47
1400000US06037552001,6037552001,2018,384,331,86.199997,307,24
1400000US06037552100,6037552100,2018,3536,2948,83.370003,2499,449
1400000US06037552200,6037552200,2018,365,320,87.669998,287,33
1400000US06037552301,6037552301,2018,443,390,88.040001,357,33
1400000US06037552302,6037552302,2018,1283,1084,84.489998,948,136
1400000US06037552601,6037552601,2018,464,432,93.099998,396,36
1400000US06037552602,6037552602,2018,499,439,87.980003,382,57
1400000US06037552700,6037552700,2018,590,540,91.529999,475,65
1400000US06037552800,6037552800,2018,2096,1748,83.400002,1486,262
1400000US06037553000,6037553000,2018,502,432,86.059998,364,68
1400000US06037553100,6037553100,2018,2923,2191,74.959999,1843,348
1400000US06037553300,6037553300,2018,411,328,79.809998,271,57
1400000US06037553502,6037553502,2018,6023,5544,92.050003,5029,515
1400000US06037553504,6037553504,2018,636,600,94.339996,562,38
1400000US06037553601,6037553601,2018,547,533,97.440002,508,25
1400000US06037553701,6037553701,2018,588,562,95.580002,537,25
1400000US06037553702,6037553702,2018,1448,1349,93.160004,1275,74
1400000US06037553802,6037553802,2018,1275,1188,93.18,1089,99
1400000US06037553901,6037553901,2018,1026,944,92.010002,851,93
1400000US06037553902,6037553902,2018,1656,1540,93,1407,133
1400000US06037554002,6037554002,2018,705,622,88.230003,551,71
1400000US06037554106,6037554106,2018,528,482,91.290001,423,59
1400000US06037554201,6037554201,2018,731,622,85.089996,556,66
1400000US06037554405,6037554405,2018,747,559,74.830002,489,70
1400000US06037554511,6037554511,2018,2038,622,30.52,493,129
1400000US06037554512,6037554512,2018,1586,399,25.16,316,83
1400000US06037554514,6037554514,2018,601,414,68.889999,363,51
1400000US06037554515,6037554515,2018,777,265,34.110001,211,54
1400000US06037554516,6037554516,2018,3928,1527,38.869999,1206,321
1400000US06037554517,6037554517,2018,743,151,20.32,121,30
1400000US06037554518,6037554518,2018,665,137,20.6,106,31
1400000US06037554521,6037554521,2018,1902,1045,54.939999,845,200
1400000US06037554522,6037554522,2018,1181,600,50.799999,508,92
1400000US06037554700,6037554700,2018,331,308,93.050003,297,11
1400000US06037554801,6037554801,2018,706,499,70.68,417,82
1400000US06037554802,6037554802,2018,1554,959,61.709999,799,160
1400000US06037555001,6037555001,2018,434,381,87.790001,350,31
1400000US06037555002,6037555002,2018,360,312,86.669998,280,32
1400000US06037555105,6037555105,2018,2049,1553,75.790001,1377,176
1400000US06037555106,6037555106,2018,389,347,89.199997,332,15
1400000US06037555107,6037555107,2018,481,450,93.559998,415,35
1400000US06037555211,6037555211,2018,380,371,97.629997,349,22
1400000US06037555212,6037555212,2018,365,353,96.709999,329,24
1400000US06037555300,6037555300,2018,412,300,72.82,230,70
1400000US06037570001,6037570001,2018,3643,1978,54.299999,1673,305
1400000US06037570002,6037570002,2018,651,567,87.099998,504,63
1400000US06037570100,6037570100,2018,551,503,91.290001,481,22
1400000US06037570202,6037570202,2018,917,807,88,697,110
1400000US06037570203,6037570203,2018,672,626,93.150002,547,79
1400000US06037570402,6037570402,2018,1232,1114,90.419998,959,155
1400000US06037570403,6037570403,2018,720,601,83.470001,536,65
1400000US06037570504,6037570504,2018,3614,3159,87.410004,2686,473
1400000US06037570601,6037570601,2018,628,579,92.199997,499,80
1400000US06037570602,6037570602,2018,890,800,89.889999,676,124
1400000US06037570701,6037570701,2018,520,414,79.620003,364,50
1400000US06037570800,6037570800,2018,1418,721,50.849998,573,148
1400000US06037570902,6037570902,2018,745,379,50.869999,282,97
1400000US06037571000,6037571000,2018,456,146,32.02,124,22
1400000US06037571101,6037571101,2018,359,172,47.91,144,28
1400000US06037571102,6037571102,2018,3140,1796,57.200001,1345,451
1400000US06037571202,6037571202,2018,1546,798,51.619999,620,178
1400000US06037571300,6037571300,2018,1177,792,67.290001,605,187
1400000US06037571400,6037571400,2018,380,213,56.049999,149,64
1400000US06037571502,6037571502,2018,579,530,91.540001,476,54
1400000US06037571701,6037571701,2018,1782,1608,90.239998,1426,182
1400000US06037571703,6037571703,2018,894,840,93.959999,743,97
1400000US06037571800,6037571800,2018,524,227,43.32,173,54
1400000US06037571900,6037571900,2018,2463,1302,52.860001,992,310
1400000US06037572202,6037572202,2018,1524,1331,87.339996,1150,181
1400000US06037572500,6037572500,2018,563,513,91.120003,434,79
1400000US06037572600,6037572600,2018,801,718,89.639999,612,106
1400000US06037572700,6037572700,2018,698,640,91.690002,539,101
1400000US06037573101,6037573101,2018,928,774,83.410004,677,97
1400000US06037573201,6037573201,2018,840,788,93.809998,699,89
1400000US06037573300,6037573300,2018,403,330,81.889999,275,55
1400000US06037573402,6037573402,2018,1520,1359,89.410004,1183,176
1400000US06037573601,6037573601,2018,400,191,47.75,147,44
1400000US06037573700,6037573700,2018,813,211,25.950001,155,56
1400000US06037573800,6037573800,2018,987,438,44.380001,321,117
1400000US06037573902,6037573902,2018,858,213,24.83,149,64
1400000US06037574000,6037574000,2018,1017,282,27.73,214,68
1400000US06037574100,6037574100,2018,1452,563,38.77,452,111
1400000US06037574201,6037574201,2018,426,211,49.529999,161,50
1400000US06037574202,6037574202,2018,147,118,80.269997,106,12
1400000US06037574300,6037574300,2018,1784,585,32.790001,460,125
1400000US06037574400,6037574400,2018,4043,1540,38.09,1177,363
1400000US06037574500,6037574500,2018,701,301,42.939999,230,71
1400000US06037574602,6037574602,2018,306,109,35.619999,88,21
1400000US06037574901,6037574901,2018,582,131,22.51,106,25
1400000US06037575001,6037575001,2018,128,100,78.129997,85,15
1400000US06037575002,6037575002,2018,365,290,79.449997,239,51
1400000US06037575101,6037575101,2018,878,830,94.529999,739,91
1400000US06037575201,6037575201,2018,989,836,84.529999,764,72
1400000US06037575300,6037575300,2018,5107,3467,67.889999,3066,401
1400000US06037575401,6037575401,2018,1663,1324,79.620003,1224,100
1400000US06037575402,6037575402,2018,61,33,54.099998,30,3
1400000US06037575901,6037575901,2018,595,558,93.779999,517,41
1400000US06037576200,6037576200,2018,1011,864,85.459999,790,74
1400000US06037576301,6037576301,2018,1137,910,80.040001,801,109
1400000US06037576401,6037576401,2018,1031,983,95.339996,920,63
1400000US06037576501,6037576501,2018,1297,1200,92.519997,1081,119
1400000US06037576801,6037576801,2018,691,614,88.860001,540,74
1400000US06037576903,6037576903,2018,710,658,92.68,590,68
1400000US06037577000,6037577000,2018,4711,3136,66.57,2613,523
1400000US06037577100,6037577100,2018,865,406,46.939999,326,80
1400000US06037577501,6037577501,2018,338,50,14.79,44,6
1400000US06037577602,6037577602,2018,361,119,32.959999,101,18
1400000US06037577606,6037577606,2018,1548,315,20.35,263,52
1400000US06037577700,6037577700,2018,1063,880,82.779999,700,180
1400000US06037577800,6037577800,2018,614,446,72.639999,322,124
1400000US06037577900,6037577900,2018,466,296,63.52,277,19
1400000US06037578000,6037578000,2018,3137,2594,82.690002,2208,386
1400000US06037599000,6037599000,2018,559,390,69.769997,262,128
1400000US06037600201,6037600201,2018,925,901,97.410004,882,19
1400000US06037600302,6037600302,2018,1846,1681,91.059998,1596,85
1400000US06037600303,6037600303,2018,782,754,96.419998,729,25
1400000US06037600501,6037600501,2018,307,284,92.510002,267,17
1400000US06037600602,6037600602,2018,1588,1275,80.290001,1241,34
1400000US06037600702,6037600702,2018,164,141,85.980003,126,15
1400000US06037600703,6037600703,2018,613,576,93.959999,538,38
1400000US06037600801,6037600801,2018,449,388,86.410004,371,17
1400000US06037600911,6037600911,2018,610,549,90,524,25
1400000US06037601001,6037601001,2018,98,68,69.389999,65,3
1400000US06037601002,6037601002,2018,730,642,87.949997,567,75
1400000US06037601202,6037601202,2018,1108,983,88.720001,908,75
1400000US06037601211,6037601211,2018,1460,1165,79.790001,1079,86
1400000US06037601212,6037601212,2018,412,394,95.629997,316,78
1400000US06037601301,6037601301,2018,686,527,76.82,466,61
1400000US06037601303,6037601303,2018,1170,848,72.480003,750,98
1400000US06037601401,6037601401,2018,694,587,84.580002,558,29
1400000US06037601402,6037601402,2018,560,522,93.209999,487,35
1400000US06037601501,6037601501,2018,229,109,47.599998,56,53
1400000US06037601502,6037601502,2018,1415,1348,95.269997,1238,110
1400000US06037601600,6037601600,2018,2137,2050,95.93,1867,183
1400000US06037601700,6037601700,2018,2052,1924,93.760002,1702,222
1400000US06037601802,6037601802,2018,623,600,96.309998,541,59
1400000US06037602003,6037602003,2018,401,378,94.260002,345,33
1400000US06037602104,6037602104,2018,565,515,91.150002,481,34
1400000US06037602106,6037602106,2018,1506,1316,87.379997,1178,138
1400000US06037602201,6037602201,2018,3359,2128,63.349998,1841,287
1400000US06037602302,6037602302,2018,1980,805,40.66,625,180
1400000US06037602402,6037602402,2018,753,563,74.769997,477,86
1400000US06037602403,6037602403,2018,1501,1323,88.139999,1206,117
1400000US06037602404,6037602404,2018,555,518,93.330002,457,61
1400000US06037602505,6037602505,2018,891,777,87.209999,703,74
1400000US06037602506,6037602506,2018,661,586,88.650002,546,40
1400000US06037602511,6037602511,2018,1806,1643,90.970001,1553,90
1400000US06037602601,6037602601,2018,462,411,88.959999,365,46
1400000US06037602700,6037602700,2018,354,315,88.980003,290,25
1400000US06037602801,6037602801,2018,1177,1073,91.160004,999,74
1400000US06037602802,6037602802,2018,1264,1187,93.910004,1136,51
1400000US06037603006,6037603006,2018,382,347,90.839996,330,17
1400000US06037603008,6037603008,2018,758,675,89.050003,600,75
1400000US06037603200,6037603200,2018,1375,1169,85.019997,1053,116
1400000US06037603301,6037603301,2018,2024,1728,85.379997,1510,218
1400000US06037603400,6037603400,2018,756,560,74.07,475,85
1400000US06037603600,6037603600,2018,192,144,75,129,15
1400000US06037603702,6037603702,2018,550,366,66.550003,313,53
1400000US06037603705,6037603705,2018,189,160,84.660004,160,0
1400000US06037603706,6037603706,2018,600,534,89,497,37
1400000US06037603801,6037603801,2018,1789,1596,89.209999,1406,190
1400000US06037603802,6037603802,2018,1707,1480,86.699997,1338,142
1400000US06037603901,6037603901,2018,3358,2829,84.25,2447,382
1400000US06037603902,6037603902,2018,875,716,81.830002,630,86
1400000US06037604001,6037604001,2018,512,422,82.419998,356,66
1400000US06037604002,6037604002,2018,690,580,84.059998,534,46
1400000US06037604200,6037604200,2018,1508,1261,83.620003,1156,105
1400000US06037620001,6037620001,2018,785,115,14.65,79,36
1400000US06037620002,6037620002,2018,826,153,18.52,126,27
1400000US06037620101,6037620101,2018,1806,300,16.610001,243,57
1400000US06037620303,6037620303,2018,614,10,1.63,8,2
1400000US06037620305,6037620305,2018,698,15,2.1500001,15,0
1400000US06037620400,6037620400,2018,1849,79,4.27,74,5
1400000US06037620501,6037620501,2018,625,58,9.2799997,48,10
1400000US06037620521,6037620521,2018,450,114,25.33,100,14
1400000US06037620602,6037620602,2018,1816,408,22.469999,340,68
1400000US06037620701,6037620701,2018,431,74,17.17,63,11
1400000US06037620703,6037620703,2018,639,38,5.9499998,36,2
1400000US06037620802,6037620802,2018,2931,175,5.9699998,156,19
1400000US06037620904,6037620904,2018,384,10,2.5999999,10,0
1400000US06037621005,6037621005,2018,1345,58,4.3099999,54,4
1400000US06037621201,6037621201,2018,4654,815,17.51,693,122
1400000US06037621301,6037621301,2018,675,85,12.59,79,6
1400000US06037621400,6037621400,2018,476,66,13.87,58,8
1400000US06037650001,6037650001,2018,1132,465,41.080002,342,123
1400000US06037650004,6037650004,2018,343,202,58.889999,176,26
1400000US06037650101,6037650101,2018,581,215,37.009998,167,48
1400000US06037650200,6037650200,2018,2568,1176,45.790001,959,217
1400000US06037650300,6037650300,2018,565,284,50.27,236,48
1400000US06037650401,6037650401,2018,1305,445,34.099998,367,78
1400000US06037650502,6037650502,2018,1271,240,18.879999,186,54
1400000US06037650603,6037650603,2018,2954,722,24.440001,581,141
1400000US06037650701,6037650701,2018,627,141,22.49,115,26
1400000US06037650702,6037650702,2018,625,73,11.68,69,4
1400000US06037650903,6037650903,2018,1916,662,34.549999,535,127
1400000US06037650904,6037650904,2018,632,392,62.029999,347,45
1400000US06037651001,6037651001,2018,715,355,49.650002,286,69
1400000US06037651002,6037651002,2018,821,329,40.07,279,50
1400000US06037651101,6037651101,2018,942,147,15.61,110,37
1400000US06037651201,6037651201,2018,516,87,16.860001,77,10
1400000US06037651221,6037651221,2018,700,164,23.43,137,27
1400000US06037651222,6037651222,2018,2725,526,19.299999,429,97
1400000US06037651302,6037651302,2018,1383,204,14.75,172,32
1400000US06037651402,6037651402,2018,646,109,16.870001,93,16
1400000US06037670002,6037670002,2018,1350,1150,85.190002,1014,136
1400000US06037670003,6037670003,2018,920,623,67.720001,508,115
1400000US06037670101,6037670101,2018,532,453,85.150002,393,60
1400000US06037670202,6037670202,2018,418,31,7.4200001,30,1
1400000US06037670324,6037670324,2018,626,56,8.9499998,52,4
1400000US06037670326,6037670326,2018,465,29,6.2399998,24,5
1400000US06037670328,6037670328,2018,2945,168,5.6999998,159,9
1400000US06037670405,6037670405,2018,910,61,6.6999998,55,6
1400000US06037670413,6037670413,2018,439,30,6.8299999,28,2
1400000US06037670416,6037670416,2018,326,47,14.42,43,4
1400000US06037670417,6037670417,2018,2746,210,7.6500001,194,16
1400000US06037670418,6037670418,2018,941,40,4.25,36,4
1400000US06037670500,6037670500,2018,52,15,28.85,14,1
1400000US06037670604,6037670604,2018,363,21,5.79,20,1
1400000US06037670701,6037670701,2018,2113,1404,66.449997,1149,255
1400000US06037670702,6037670702,2018,917,94,10.25,81,13
1400000US06037700200,6037700200,2018,1768,911,51.529999,734,177
1400000US06037700400,6037700400,2018,252,128,50.790001,95,33
1400000US06037700501,6037700501,2018,413,79,19.129999,72,7
1400000US06037700600,6037700600,2018,556,98,17.629999,83,15
1400000US06037700700,6037700700,2018,600,78,13,70,8
1400000US06037700802,6037700802,2018,154,56,36.360001,50,6
1400000US06037700901,6037700901,2018,553,108,19.530001,98,10
1400000US06037700902,6037700902,2018,717,126,17.57,114,12
1400000US06037701000,6037701000,2018,1412,242,17.139999,224,18
1400000US06037701304,6037701304,2018,776,88,11.34,75,13
1400000US06037701501,6037701501,2018,1077,170,15.78,141,29
1400000US06037701601,6037701601,2018,782,50,6.3899999,47,3
1400000US06037701602,6037701602,2018,472,188,39.830002,143,45
1400000US06037701801,6037701801,2018,437,179,40.959999,140,39
1400000US06037701902,6037701902,2018,2735,725,26.51,605,120
1400000US06037702002,6037702002,2018,562,175,31.139999,155,20
1400000US06037702201,6037702201,2018,1573,631,40.110001,524,107
1400000US06037702300,6037702300,2018,595,176,29.58,136,40
1400000US06037702400,6037702400,2018,558,185,33.150002,165,20
1400000US06037702600,6037702600,2018,1394,327,23.459999,271,56
1400000US06037702700,6037702700,2018,4392,1494,34.02,1294,200
1400000US06037702801,6037702801,2018,584,356,60.959999,315,41
1400000US06037702803,6037702803,2018,652,449,68.870003,386,63
1400000US06037703002,6037703002,2018,548,392,71.529999,363,29
1400000US06037703100,6037703100,2018,512,418,81.639999,362,56
1400000US06037703200,6037703200,2018,295,264,89.489998,245,19
1400000US06037800101,6037800101,2018,3397,449,13.22,399,50
1400000US06037800103,6037800103,2018,290,45,15.52,43,2
1400000US06037800202,6037800202,2018,1431,168,11.74,150,18
1400000US06037800205,6037800205,2018,532,118,22.18,101,17
1400000US06037800206,6037800206,2018,588,42,7.1399999,37,5
1400000US06037800325,6037800325,2018,443,28,6.3200002,26,2
1400000US06037800334,6037800334,2018,2764,387,14,359,28
1400000US06037800335,6037800335,2018,22,22,100,22,0
1400000US06037800338,6037800338,2018,1950,215,11.03,188,27
1400000US06037800406,6037800406,2018,21,21,100,21,0
1400000US06037800411,6037800411,2018,1123,151,13.45,144,7
1400000US06037800412,6037800412,2018,196,23,11.73,23,0
1400000US06037800504,6037800504,2018,271,32,11.81,27,5
1400000US06037900102,6037900102,2018,682,644,94.43,606,38
1400000US06037900103,6037900103,2018,609,554,90.970001,506,48
1400000US06037900104,6037900104,2018,513,452,88.110001,433,19
1400000US06037900301,6037900301,2018,723,640,88.519997,599,41
1400000US06037900501,6037900501,2018,537,494,91.989998,472,22
1400000US06037900504,6037900504,2018,4249,3555,83.669998,3277,278
1400000US06037900505,6037900505,2018,762,698,91.599998,646,52
1400000US06037900508,6037900508,2018,2245,1890,84.190002,1761,129
1400000US06037900510,6037900510,2018,1452,1260,86.779999,1194,66
1400000US06037900602,6037900602,2018,1001,930,92.910004,899,31
1400000US06037900606,6037900606,2018,3067,2590,84.449997,2492,98
1400000US06037900607,6037900607,2018,636,601,94.5,576,25
1400000US06037900609,6037900609,2018,773,691,89.389999,644,47
1400000US06037900610,6037900610,2018,603,532,88.230003,488,44
1400000US06037900701,6037900701,2018,1104,1037,93.93,1008,29
1400000US06037900703,6037900703,2018,1440,1246,86.529999,1147,99
1400000US06037900804,6037900804,2018,532,486,91.349998,468,18
1400000US06037900805,6037900805,2018,766,664,86.68,628,36
1400000US06037900807,6037900807,2018,724,645,89.089996,612,33
1400000US06037900901,6037900901,2018,828,383,46.259998,337,46
1400000US06037901007,6037901007,2018,788,473,60.029999,440,33
1400000US06037901009,6037901009,2018,971,771,79.400002,701,70
1400000US06037901010,6037901010,2018,749,572,76.370003,521,51
1400000US06037901011,6037901011,2018,705,520,73.760002,470,50
1400000US06037901012,6037901012,2018,752,573,76.199997,529,44
1400000US06037901013,6037901013,2018,1153,679,58.889999,606,73
1400000US06037901014,6037901014,2018,2342,1513,64.599998,1373,140
1400000US06037901101,6037901101,2018,1095,592,54.060001,542,50
1400000US06037901209,6037901209,2018,345,203,58.84,186,17
1400000US06037901214,6037901214,2018,960,503,52.400002,450,53
1400000US06037901215,6037901215,2018,3368,1464,43.470001,1267,197
1400000US06037901217,6037901217,2018,107,21,19.629999,21,0
1400000US06037901300,6037901300,2018,585,549,93.849998,524,25
1400000US06037910002,6037910002,2018,331,291,87.919998,264,27
1400000US06037910210,6037910210,2018,1120,538,48.040001,471,67
1400000US06037910212,6037910212,2018,886,203,22.91,176,27
1400000US06037910214,6037910214,2018,4104,2812,68.519997,2504,308
1400000US06037910215,6037910215,2018,1621,1276,78.720001,1132,144
1400000US06037910217,6037910217,2018,661,346,52.34,289,57
1400000US06037910218,6037910218,2018,555,321,57.84,316,5
1400000US06037910301,6037910301,2018,865,542,62.66,506,36
1400000US06037910302,6037910302,2018,1680,718,42.740002,645,73
1400000US06037910401,6037910401,2018,730,536,73.419998,481,55
1400000US06037910404,6037910404,2018,582,526,90.379997,494,32
1400000US06037910405,6037910405,2018,1408,1215,86.290001,1126,89
1400000US06037910504,6037910504,2018,801,763,95.260002,729,34
1400000US06037910601,6037910601,2018,675,620,91.849998,586,34
1400000US06037910602,6037910602,2018,5009,4265,85.150002,3824,441
1400000US06037910605,6037910605,2018,1668,1206,72.300003,1134,72
1400000US06037910606,6037910606,2018,101,81,80.199997,80,1
1400000US06037910608,6037910608,2018,828,749,90.459999,680,69
1400000US06037910706,6037910706,2018,735,610,82.989998,540,70
1400000US06037910712,6037910712,2018,579,492,84.970001,438,54
1400000US06037910714,6037910714,2018,1803,1539,85.360001,1377,162
1400000US06037910715,6037910715,2018,591,534,90.360001,471,63
1400000US06037910716,6037910716,2018,1558,1328,85.239998,1215,113
1400000US06037910717,6037910717,2018,4352,3425,78.699997,2951,474
1400000US06037910718,6037910718,2018,1578,1327,84.089996,1164,163
1400000US06037910720,6037910720,2018,790,715,90.510002,650,65
1400000US06037910804,6037910804,2018,2825,899,31.82,823,76
1400000US06037910807,6037910807,2018,1008,589,58.43,518,71
1400000US06037910814,6037910814,2018,187,42,22.459999,42,0
1400000US06037910815,6037910815,2018,5317,2069,38.91,1743,326
1400000US06037911001,6037911001,2018,844,693,82.110001,660,33
1400000US06037911100,6037911100,2018,2355,2002,85.010002,1850,152
1400000US06037920013,6037920013,2018,809,123,15.2,108,15
1400000US06037920015,6037920015,2018,870,105,12.07,92,13
1400000US06037920017,6037920017,2018,945,242,25.610001,204,38
1400000US06037920020,6037920020,2018,736,228,30.98,186,42
1400000US06037920029,6037920029,2018,2658,1027,38.639999,897,130
1400000US06037920031,6037920031,2018,3283,1687,51.389999,1483,204
1400000US06037920034,6037920034,2018,1094,673,61.52,597,76
1400000US06037920035,6037920035,2018,497,422,84.910004,376,46
1400000US06037920041,6037920041,2018,633,217,34.279999,197,20
1400000US06037920042,6037920042,2018,563,411,73,370,41
1400000US06037920043,6037920043,2018,1499,531,35.419998,455,76
1400000US06037920044,6037920044,2018,2395,397,16.58,340,57
1400000US06037920048,6037920048,2018,2094,1226,58.549999,1063,163
1400000US06037920049,6037920049,2018,703,119,16.93,101,18
1400000US06037920102,6037920102,2018,761,335,44.02,296,39
1400000US06037920109,6037920109,2018,702,121,17.24,108,13
1400000US06037920111,6037920111,2018,388,123,31.700001,103,20
1400000US06037920112,6037920112,2018,1294,216,16.690001,192,24
1400000US06037920115,6037920115,2018,1557,219,14.07,187,32
1400000US06037920118,6037920118,2018,1929,622,32.240002,530,92
1400000US06037920119,6037920119,2018,501,86,17.17,77,9
1400000US06037920120,6037920120,2018,602,111,18.440001,94,17
1400000US06037920121,6037920121,2018,6026,1279,21.219999,1085,194
1400000US06037920313,6037920313,2018,1043,710,68.07,663,47
1400000US06037920314,6037920314,2018,541,192,35.490002,181,11
1400000US06037920322,6037920322,2018,423,187,44.209999,175,12
1400000US06037920326,6037920326,2018,899,184,20.469999,149,35
1400000US06037920329,6037920329,2018,923,286,30.99,250,36
1400000US06037920330,6037920330,2018,402,58,14.43,54,4
1400000US06037920334,6037920334,2018,948,207,21.84,177,30
1400000US06037920338,6037920338,2018,773,89,11.51,84,5
1400000US06037920339,6037920339,2018,4116,621,15.09,527,94
1400000US06037920340,6037920340,2018,3308,1333,40.299999,1200,133
1400000US06037920341,6037920341,2018,620,576,92.900002,533,43
1400000US06037920342,6037920342,2018,673,566,84.099998,513,53
1400000US06037930400,6037930400,2018,94,26,27.66,21,5
1400000US06037980004,6037980004,2018,756,741,98.019997,704,37
1400000US06037980013,6037980013,2018,836,311,37.200001,258,53
1400000US06037980016,6037980016,2018,225,217,96.440002,212,5
1400000US06037101110,6037101110,2017,1337,1026,76.739998,806,220
1400000US06037101220,6037101220,2017,255,229,89.800003,213,16
1400000US06037101300,6037101300,2017,352,225,63.919998,167,58
1400000US06037102107,6037102107,2017,624,499,79.970001,390,109
1400000US06037103101,6037103101,2017,839,638,76.040001,531,107
1400000US06037103102,6037103102,2017,718,566,78.830002,442,124
1400000US06037103202,6037103202,2017,164,138,84.150002,106,32
1400000US06037103402,6037103402,2017,393,228,58.02,161,67
1400000US06037104103,6037104103,2017,773,680,87.970001,539,141
1400000US06037104105,6037104105,2017,1086,969,89.230003,757,212
1400000US06037104108,6037104108,2017,1390,1240,89.209999,1109,131
1400000US06037104124,6037104124,2017,1177,1007,85.559998,787,220
1400000US06037104204,6037104204,2017,551,494,89.660004,451,43
1400000US06037104310,6037104310,2017,2865,2786,97.239998,2366,420
1400000US06037104321,6037104321,2017,1269,992,78.169998,918,74
1400000US06037104401,6037104401,2017,727,655,90.099998,592,63
1400000US06037104500,6037104500,2017,783,705,90.040001,642,63
1400000US06037104821,6037104821,2017,887,309,34.84,309,0
1400000US06037104822,6037104822,2017,1241,1067,85.980003,932,135
1400000US06037106020,6037106020,2017,235,218,92.769997,185,33
1400000US06037106112,6037106112,2017,580,502,86.550003,412,90
1400000US06037106113,6037106113,2017,399,305,76.440002,227,78
1400000US06037106114,6037106114,2017,458,391,85.370003,328,63
1400000US06037106403,6037106403,2017,2305,2071,89.849998,1770,301
1400000US06037106405,6037106405,2017,2584,2165,83.779999,1868,297
1400000US06037106510,6037106510,2017,174,174,100,174,0
1400000US06037106520,6037106520,2017,1701,1356,79.720001,1094,262
1400000US06037106603,6037106603,2017,498,196,39.360001,133,63
1400000US06037106604,6037106604,2017,488,418,85.660004,370,48
1400000US06037106641,6037106641,2017,1653,909,54.990002,644,265
1400000US06037106642,6037106642,2017,480,153,31.870001,97,56
1400000US06037106646,6037106646,2017,2542,1951,76.75,1445,506
1400000US06037106648,6037106648,2017,305,257,84.260002,220,37
1400000US06037107020,6037107020,2017,695,635,91.370003,541,94
1400000US06037108104,6037108104,2017,735,102,13.88,77,25
1400000US06037108202,6037108202,2017,1104,114,10.33,75,39
1400000US06037109200,6037109200,2017,418,302,72.25,228,74
1400000US06037109300,6037109300,2017,588,438,74.489998,317,121
1400000US06037109500,6037109500,2017,1985,1850,93.199997,1524,326
1400000US06037109601,6037109601,2017,687,536,78.019997,420,116
1400000US06037109700,6037109700,2017,1617,1220,75.449997,917,303
1400000US06037109800,6037109800,2017,818,474,57.950001,305,169
1400000US06037111100,6037111100,2017,501,355,70.860001,254,101
1400000US06037111202,6037111202,2017,438,326,74.43,237,89
1400000US06037111204,6037111204,2017,3061,1372,44.82,937,435
1400000US06037111206,6037111206,2017,473,213,45.029999,157,56
1400000US06037111302,6037111302,2017,419,276,65.870003,193,83
1400000US06037111303,6037111303,2017,2219,1525,68.720001,1124,401
1400000US06037111304,6037111304,2017,4580,2167,47.310001,1292,875
1400000US06037111401,6037111401,2017,479,334,69.730003,243,91
1400000US06037113101,6037113101,2017,501,296,59.080002,229,67
1400000US06037113212,6037113212,2017,376,246,65.43,183,63
1400000US06037113232,6037113232,2017,409,317,77.510002,278,39
1400000US06037113303,6037113303,2017,659,422,64.040001,330,92
1400000US06037113322,6037113322,2017,446,159,35.650002,109,50
1400000US06037113323,6037113323,2017,1459,928,63.610001,723,205
1400000US06037113324,6037113324,2017,1945,1427,73.370003,1108,319
1400000US06037113423,6037113423,2017,190,115,60.529999,98,17
1400000US06037113428,6037113428,2017,802,700,87.279999,618,82
1400000US06037115101,6037115101,2017,2650,1574,59.400002,1151,423
1400000US06037115103,6037115103,2017,1033,752,72.800003,534,218
1400000US06037115202,6037115202,2017,556,347,62.41,261,86
1400000US06037115301,6037115301,2017,575,243,42.259998,169,74
1400000US06037115302,6037115302,2017,446,395,88.57,356,39
1400000US06037115401,6037115401,2017,829,730,88.059998,661,69
1400000US06037115403,6037115403,2017,299,213,71.239998,177,36
1400000US06037117101,6037117101,2017,3276,2866,87.480003,2597,269
1400000US06037117102,6037117102,2017,498,437,87.75,371,66
1400000US06037117202,6037117202,2017,2614,2226,85.160004,1962,264
1400000US06037117302,6037117302,2017,596,502,84.230003,462,40
1400000US06037117303,6037117303,2017,263,75,28.52,53,22
1400000US06037117407,6037117407,2017,571,536,93.870003,513,23
1400000US06037117510,6037117510,2017,489,441,90.18,368,73
1400000US06037117520,6037117520,2017,709,638,89.989998,608,30
1400000US06037117530,6037117530,2017,851,758,89.07,696,62
1400000US06037119003,6037119003,2017,681,608,89.279999,527,81
1400000US06037119004,6037119004,2017,533,400,75.050003,324,76
1400000US06037119201,6037119201,2017,1959,1617,82.540001,1371,246
1400000US06037119342,6037119342,2017,707,653,92.360001,571,82
1400000US06037119802,6037119802,2017,906,698,77.040001,536,162
1400000US06037119900,6037119900,2017,657,584,88.889999,506,78
1400000US06037120010,6037120010,2017,1183,1092,92.309998,1027,65
1400000US06037120020,6037120020,2017,832,732,87.980003,686,46
1400000US06037120030,6037120030,2017,1391,1328,95.470001,1221,107
1400000US06037120107,6037120107,2017,485,443,91.339996,421,22
1400000US06037120108,6037120108,2017,1042,960,92.129997,925,35
1400000US06037120300,6037120300,2017,404,363,89.849998,322,41
1400000US06037120400,6037120400,2017,541,438,80.959999,374,64
1400000US06037121010,6037121010,2017,4240,3677,86.720001,3160,517
1400000US06037121020,6037121020,2017,638,563,88.239998,500,63
1400000US06037121102,6037121102,2017,281,232,82.559998,191,41
1400000US06037121210,6037121210,2017,372,312,83.870003,256,56
1400000US06037121222,6037121222,2017,1384,1226,88.580002,1097,129
1400000US06037121600,6037121600,2017,102,83,81.370003,68,15
1400000US06037121801,6037121801,2017,483,433,89.650002,406,27
1400000US06037121900,6037121900,2017,433,369,85.220001,322,47
1400000US06037122000,6037122000,2017,564,442,78.370003,323,119
1400000US06037122122,6037122122,2017,610,512,83.93,471,41
1400000US06037122200,6037122200,2017,345,287,83.190002,249,38
1400000US06037122420,6037122420,2017,638,565,88.559998,518,47
1400000US06037123010,6037123010,2017,1846,1617,87.589996,1489,128
1400000US06037123301,6037123301,2017,573,513,89.529999,473,40
1400000US06037123303,6037123303,2017,759,672,88.540001,620,52
1400000US06037123420,6037123420,2017,1732,1533,88.510002,1350,183
1400000US06037123510,6037123510,2017,806,707,87.720001,632,75
1400000US06037123601,6037123601,2017,1861,1529,82.160004,1290,239
1400000US06037123602,6037123602,2017,690,566,82.029999,483,83
1400000US06037123700,6037123700,2017,698,556,79.660004,434,122
1400000US06037123901,6037123901,2017,1988,1806,90.849998,1655,151
1400000US06037124102,6037124102,2017,791,694,87.739998,631,63
1400000US06037124201,6037124201,2017,817,722,88.370003,622,100
1400000US06037124300,6037124300,2017,401,342,85.290001,296,46
1400000US06037124600,6037124600,2017,1856,817,44.02,628,189
1400000US06037124700,6037124700,2017,626,199,31.790001,154,45
1400000US06037124902,6037124902,2017,371,268,72.239998,226,42
1400000US06037125101,6037125101,2017,2498,1896,75.900002,1556,340
1400000US06037125102,6037125102,2017,639,153,23.940001,113,40
1400000US06037125310,6037125310,2017,723,518,71.650002,446,72
1400000US06037125322,6037125322,2017,408,343,84.07,311,32
1400000US06037125600,6037125600,2017,438,356,81.279999,289,67
1400000US06037127210,6037127210,2017,2517,2212,87.879997,2007,205
1400000US06037127400,6037127400,2017,526,465,88.400002,415,50
1400000US06037127603,6037127603,2017,788,684,86.800003,628,56
1400000US06037127803,6037127803,2017,253,131,51.779999,106,25
1400000US06037127805,6037127805,2017,518,438,84.559998,401,37
1400000US06037127806,6037127806,2017,2594,1906,73.480003,1573,333
1400000US06037127910,6037127910,2017,1285,813,63.27,674,139
1400000US06037127920,6037127920,2017,753,667,88.580002,612,55
1400000US06037128102,6037128102,2017,915,642,70.160004,590,52
1400000US06037128302,6037128302,2017,798,721,90.349998,663,58
1400000US06037128602,6037128602,2017,494,277,56.07,198,79
1400000US06037128802,6037128802,2017,2076,1479,71.239998,1191,288
1400000US06037128910,6037128910,2017,222,78,35.139999,51,27
1400000US06037131022,6037131022,2017,496,443,89.309998,401,42
1400000US06037131023,6037131023,2017,398,329,82.660004,286,43
1400000US06037131100,6037131100,2017,405,324,80,266,58
1400000US06037131200,6037131200,2017,602,421,69.93,316,105
1400000US06037131300,6037131300,2017,483,413,85.510002,357,56
1400000US06037131600,6037131600,2017,3454,2390,69.199997,1911,479
1400000US06037131701,6037131701,2017,35,24,68.57,17,7
1400000US06037131801,6037131801,2017,383,332,86.68,291,41
1400000US06037131900,6037131900,2017,439,365,83.139999,295,70
1400000US06037132001,6037132001,2017,385,312,81.040001,227,85
1400000US06037132002,6037132002,2017,6107,4927,80.68,4058,869
1400000US06037132301,6037132301,2017,393,332,84.480003,292,40
1400000US06037132501,6037132501,2017,12,9,75,7,2
1400000US06037132700,6037132700,2017,2083,1792,86.029999,1515,277
1400000US06037133000,6037133000,2017,468,399,85.260002,339,60
1400000US06037133101,6037133101,2017,399,344,86.220001,297,47
1400000US06037133102,6037133102,2017,2079,1185,57,819,366
1400000US06037134001,6037134001,2017,762,710,93.18,661,49
1400000US06037134002,6037134002,2017,396,229,57.830002,229,0
1400000US06037134101,6037134101,2017,502,423,84.260002,362,61
1400000US06037134103,6037134103,2017,523,446,85.279999,419,27
1400000US06037134104,6037134104,2017,384,345,89.839996,283,62
1400000US06037134302,6037134302,2017,434,355,81.800003,285,70
1400000US06037134303,6037134303,2017,675,603,89.330002,564,39
1400000US06037134304,6037134304,2017,1104,909,82.339996,778,131
1400000US06037134421,6037134421,2017,602,132,21.93,96,36
1400000US06037134422,6037134422,2017,253,174,68.769997,134,40
1400000US06037134423,6037134423,2017,380,155,40.790001,105,50
1400000US06037134520,6037134520,2017,1380,1211,87.75,1049,162
1400000US06037134522,6037134522,2017,716,647,90.360001,607,40
1400000US06037134720,6037134720,2017,1449,1190,82.129997,1018,172
1400000US06037134801,6037134801,2017,433,376,86.839996,315,61
1400000US06037135102,6037135102,2017,396,198,50,149,49
1400000US06037135202,6037135202,2017,806,107,13.28,72,35
1400000US06037135204,6037135204,2017,871,216,24.799999,164,52
1400000US06037137000,6037137000,2017,3549,911,25.67,684,227
1400000US06037137104,6037137104,2017,827,667,80.650002,549,118
1400000US06037137203,6037137203,2017,782,510,65.220001,397,113
1400000US06037137301,6037137301,2017,508,195,38.389999,161,34
1400000US06037137302,6037137302,2017,2056,741,36.040001,543,198
1400000US06037137401,6037137401,2017,694,93,13.4,59,34
1400000US06037137402,6037137402,2017,422,79,18.719999,50,29
1400000US06037137501,6037137501,2017,3034,1916,63.150002,1477,439
1400000US06037139001,6037139001,2017,319,117,36.68,79,38
1400000US06037139200,6037139200,2017,375,246,65.599998,208,38
1400000US06037139301,6037139301,2017,776,634,81.699997,513,121
1400000US06037139402,6037139402,2017,3279,1295,39.490002,1025,270
1400000US06037139502,6037139502,2017,543,342,62.98,250,92
1400000US06037139600,6037139600,2017,563,136,24.16,100,36
1400000US06037139701,6037139701,2017,556,29,5.2199998,19,10
1400000US06037141101,6037141101,2017,718,179,24.93,143,36
1400000US06037141304,6037141304,2017,819,234,28.57,178,56
1400000US06037141400,6037141400,2017,555,85,15.32,67,18
1400000US06037143200,6037143200,2017,826,549,66.459999,455,94
1400000US06037143302,6037143302,2017,1599,862,53.91,688,174
1400000US06037143700,6037143700,2017,222,49,22.07,42,7
1400000US06037143801,6037143801,2017,969,60,6.1900001,43,17
1400000US06037181000,6037181000,2017,1063,820,77.139999,678,142
1400000US06037181400,6037181400,2017,791,420,53.099998,293,127
1400000US06037181500,6037181500,2017,913,528,57.830002,412,116
1400000US06037181600,6037181600,2017,2332,1469,62.990002,1090,379
1400000US06037183101,6037183101,2017,1221,1029,84.279999,892,137
1400000US06037183104,6037183104,2017,269,225,83.639999,187,38
1400000US06037183220,6037183220,2017,261,225,86.209999,202,23
1400000US06037183221,6037183221,2017,121,118,97.519997,118,0
1400000US06037183401,6037183401,2017,385,292,75.839996,242,50
1400000US06037183402,6037183402,2017,318,261,82.080002,217,44
1400000US06037183510,6037183510,2017,1412,1247,88.309998,1025,222
1400000US06037183520,6037183520,2017,407,382,93.860001,351,31
1400000US06037183702,6037183702,2017,227,209,92.07,167,42
1400000US06037183810,6037183810,2017,588,537,91.330002,486,51
1400000US06037185101,6037185101,2017,552,428,77.540001,352,76
1400000US06037185102,6037185102,2017,495,357,72.120003,315,42
1400000US06037185204,6037185204,2017,433,65,15.01,42,23
1400000US06037185310,6037185310,2017,1051,949,90.290001,850,99
1400000US06037186100,6037186100,2017,475,307,64.629997,217,90
1400000US06037186302,6037186302,2017,203,176,86.699997,146,30
1400000US06037186401,6037186401,2017,1979,1677,84.739998,1458,219
1400000US06037186404,6037186404,2017,356,320,89.889999,283,37
1400000US06037187101,6037187101,2017,282,240,85.110001,192,48
1400000US06037187102,6037187102,2017,1463,944,64.519997,746,198
1400000US06037187300,6037187300,2017,388,317,81.699997,250,67
1400000US06037188201,6037188201,2017,455,74,16.26,52,22
1400000US06037188300,6037188300,2017,298,232,77.849998,208,24
1400000US06037189201,6037189201,2017,463,389,84.019997,331,58
1400000US06037189501,6037189501,2017,324,245,75.620003,206,39
1400000US06037189905,6037189905,2017,372,232,62.369999,179,53
1400000US06037190102,6037190102,2017,1469,1273,86.660004,1073,200
1400000US06037190510,6037190510,2017,531,492,92.660004,445,47
1400000US06037190701,6037190701,2017,141,123,87.230003,111,12
1400000US06037190901,6037190901,2017,1170,1102,94.190002,991,111
1400000US06037190902,6037190902,2017,1066,930,87.239998,815,115
1400000US06037191120,6037191120,2017,425,372,87.529999,348,24
1400000US06037191204,6037191204,2017,589,532,90.32,497,35
1400000US06037191301,6037191301,2017,155,132,85.160004,121,11
1400000US06037191410,6037191410,2017,430,410,95.349998,366,44
1400000US06037191720,6037191720,2017,940,910,96.809998,836,74
1400000US06037191810,6037191810,2017,491,440,89.610001,390,50
1400000US06037191901,6037191901,2017,814,670,82.309998,603,67
1400000US06037192001,6037192001,2017,333,184,55.259998,138,46
1400000US06037192002,6037192002,2017,1881,1589,84.480003,1229,360
1400000US06037192410,6037192410,2017,228,178,78.07,145,33
1400000US06037192520,6037192520,2017,414,361,87.199997,333,28
1400000US06037192620,6037192620,2017,724,646,89.230003,600,46
1400000US06037192700,6037192700,2017,476,430,90.339996,383,47
1400000US06037194300,6037194300,2017,512,56,10.94,35,21
1400000US06037195201,6037195201,2017,2782,1894,68.080002,1465,429
1400000US06037195300,6037195300,2017,1942,1456,74.970001,1175,281
1400000US06037195400,6037195400,2017,384,225,58.59,163,62
1400000US06037195500,6037195500,2017,283,250,88.339996,208,42
1400000US06037195710,6037195710,2017,979,896,91.519997,817,79
1400000US06037197200,6037197200,2017,295,242,82.029999,191,51
1400000US06037197300,6037197300,2017,258,170,65.889999,146,24
1400000US06037197410,6037197410,2017,154,108,70.129997,84,24
1400000US06037197420,6037197420,2017,830,710,85.540001,603,107
1400000US06037199001,6037199001,2017,248,160,64.519997,132,28
1400000US06037199002,6037199002,2017,350,325,92.860001,294,31
1400000US06037199120,6037199120,2017,218,204,93.580002,184,20
1400000US06037199201,6037199201,2017,411,321,78.099998,304,17
1400000US06037199202,6037199202,2017,1349,1243,92.139999,1087,156
1400000US06037199300,6037199300,2017,689,569,82.580002,533,36
1400000US06037199400,6037199400,2017,183,168,91.800003,159,9
1400000US06037199700,6037199700,2017,1641,1495,91.099998,1316,179
1400000US06037199801,6037199801,2017,433,393,90.760002,356,37
1400000US06037199802,6037199802,2017,671,591,88.080002,536,55
1400000US06037201120,6037201120,2017,258,199,77.129997,170,29
1400000US06037201200,6037201200,2017,367,317,86.379997,282,35
1400000US06037201301,6037201301,2017,349,323,92.550003,290,33
1400000US06037201401,6037201401,2017,1732,1572,90.760002,1347,225
1400000US06037201402,6037201402,2017,1886,1689,89.550003,1452,237
1400000US06037201501,6037201501,2017,301,263,87.379997,232,31
1400000US06037201602,6037201602,2017,391,329,84.139999,271,58
1400000US06037201700,6037201700,2017,550,42,7.6399999,34,8
1400000US06037203100,6037203100,2017,470,441,93.830002,422,19
1400000US06037203200,6037203200,2017,773,728,94.18,680,48
1400000US06037203300,6037203300,2017,2036,1686,82.809998,1415,271
1400000US06037203500,6037203500,2017,200,179,89.5,167,12
1400000US06037203601,6037203601,2017,871,805,92.419998,746,59
1400000US06037203800,6037203800,2017,663,608,91.699997,558,50
1400000US06037204110,6037204110,2017,220,198,90,158,40
1400000US06037204300,6037204300,2017,2570,2453,95.449997,2212,241
1400000US06037204410,6037204410,2017,365,320,87.669998,294,26
1400000US06037204420,6037204420,2017,951,840,88.330002,789,51
1400000US06037204700,6037204700,2017,2363,2198,93.019997,1985,213
1400000US06037204810,6037204810,2017,1539,1392,90.449997,1270,122
1400000US06037204820,6037204820,2017,610,578,94.75,527,51
1400000US06037204910,6037204910,2017,1400,1294,92.43,1166,128
1400000US06037205110,6037205110,2017,1047,984,93.980003,889,95
1400000US06037205120,6037205120,2017,109,100,91.739998,95,5
1400000US06037206010,6037206010,2017,358,288,80.449997,242,46
1400000US06037206050,6037206050,2017,93,77,82.800003,73,4
1400000US06037206051,6037206051,2017,462,434,93.940002,384,50
1400000US06037206054,6037206054,2017,1417,1249,88.139999,1147,102
1400000US06037207101,6037207101,2017,1426,1097,76.93,887,210
1400000US06037207103,6037207103,2017,646,479,74.150002,403,76
1400000US06037207400,6037207400,2017,364,355,97.529999,350,5
1400000US06037208001,6037208001,2017,3203,2834,88.480003,2566,268
1400000US06037208002,6037208002,2017,622,542,87.139999,486,56
1400000US06037208302,6037208302,2017,1570,1352,86.110001,1258,94
1400000US06037208401,6037208401,2017,1107,1050,94.849998,1014,36
1400000US06037208501,6037208501,2017,826,445,53.869999,379,66
1400000US06037208610,6037208610,2017,494,460,93.120003,424,36
1400000US06037208710,6037208710,2017,85,65,76.470001,64,1
1400000US06037208720,6037208720,2017,74,67,90.540001,57,10
1400000US06037208801,6037208801,2017,540,472,87.410004,465,7
1400000US06037208802,6037208802,2017,407,370,90.910004,360,10
1400000US06037208902,6037208902,2017,1333,1292,96.919998,1277,15
1400000US06037209103,6037209103,2017,889,752,84.589996,731,21
1400000US06037209104,6037209104,2017,358,358,100,358,0
1400000US06037209106,6037209106,2017,983,924,94,890,34
1400000US06037209202,6037209202,2017,1160,1065,91.809998,1009,56
1400000US06037209520,6037209520,2017,162,149,91.980003,136,13
1400000US06037209820,6037209820,2017,205,191,93.169998,171,20
1400000US06037210010,6037210010,2017,817,771,94.370003,739,32
1400000US06037211000,6037211000,2017,1786,1434,80.290001,1139,295
1400000US06037211121,6037211121,2017,1108,988,89.169998,911,77
1400000US06037211122,6037211122,2017,2915,2597,89.089996,2356,241
1400000US06037211123,6037211123,2017,922,855,92.730003,793,62
1400000US06037211124,6037211124,2017,609,581,95.400002,537,44
1400000US06037211202,6037211202,2017,736,652,88.589996,622,30
1400000US06037211410,6037211410,2017,730,629,86.160004,500,129
1400000US06037211420,6037211420,2017,499,411,82.360001,327,84
1400000US06037212202,6037212202,2017,733,656,89.5,635,21
1400000US06037212204,6037212204,2017,797,717,89.959999,612,105
1400000US06037212303,6037212303,2017,236,223,94.489998,210,13
1400000US06037212304,6037212304,2017,3950,3452,87.389999,3191,261
1400000US06037212610,6037212610,2017,1112,939,84.440002,774,165
1400000US06037212800,6037212800,2017,1701,1508,88.650002,1336,172
1400000US06037213201,6037213201,2017,644,578,89.75,539,39
1400000US06037213202,6037213202,2017,718,631,87.879997,590,41
1400000US06037213310,6037213310,2017,175,168,96,161,7
1400000US06037213320,6037213320,2017,1100,1028,93.449997,965,63
1400000US06037213402,6037213402,2017,698,667,95.559998,647,20
1400000US06037214100,6037214100,2017,634,153,24.129999,116,37
1400000US06037214501,6037214501,2017,700,178,25.43,129,49
1400000US06037216201,6037216201,2017,154,136,88.309998,118,18
1400000US06037216301,6037216301,2017,357,250,70.029999,195,55
1400000US06037216700,6037216700,2017,2011,1342,66.730003,1084,258
1400000US06037217101,6037217101,2017,349,313,89.68,286,27
1400000US06037218110,6037218110,2017,1981,1439,72.639999,1304,135
1400000US06037218210,6037218210,2017,514,503,97.860001,455,48
1400000US06037218300,6037218300,2017,303,249,82.18,208,41
1400000US06037218800,6037218800,2017,625,607,97.120003,561,46
1400000US06037218900,6037218900,2017,762,697,91.470001,572,125
1400000US06037219010,6037219010,2017,568,487,85.739998,467,20
1400000US06037219300,6037219300,2017,624,574,91.989998,522,52
1400000US06037219700,6037219700,2017,1055,901,85.400002,815,86
1400000US06037219800,6037219800,2017,592,514,86.82,459,55
1400000US06037219902,6037219902,2017,847,746,88.080002,671,75
1400000US06037220000,6037220000,2017,371,355,95.690002,325,30
1400000US06037220100,6037220100,2017,991,604,60.950001,525,79
1400000US06037221120,6037221120,2017,1090,1011,92.75,951,60
1400000US06037221304,6037221304,2017,812,703,86.580002,660,43
1400000US06037221401,6037221401,2017,1102,992,90.019997,921,71
1400000US06037221602,6037221602,2017,2271,2039,89.779999,1953,86
1400000US06037221810,6037221810,2017,615,553,89.919998,511,42
1400000US06037221900,6037221900,2017,415,397,95.660004,358,39
1400000US06037222002,6037222002,2017,636,552,86.790001,509,43
1400000US06037222500,6037222500,2017,1946,1809,92.959999,1592,217
1400000US06037222600,6037222600,2017,627,557,88.839996,533,24
1400000US06037224010,6037224010,2017,36,36,100,36,0
1400000US06037224020,6037224020,2017,1779,1581,88.870003,1433,148
1400000US06037224320,6037224320,2017,434,411,94.699997,386,25
1400000US06037224410,6037224410,2017,1946,1818,93.419998,1628,190
1400000US06037224420,6037224420,2017,949,836,88.089996,812,24
1400000US06037224600,6037224600,2017,1292,1182,91.489998,1121,61
1400000US06037224702,6037224702,2017,1047,954,91.120003,760,194
1400000US06037226001,6037226001,2017,3113,2815,90.43,2661,154
1400000US06037226002,6037226002,2017,1060,978,92.260002,918,60
1400000US06037226702,6037226702,2017,1410,1311,92.980003,1231,80
1400000US06037227020,6037227020,2017,1427,1362,95.440002,1281,81
1400000US06037228100,6037228100,2017,1798,1700,94.550003,1610,90
1400000US06037228210,6037228210,2017,1697,1487,87.629997,1396,91
1400000US06037228310,6037228310,2017,1286,1180,91.760002,1119,61
1400000US06037228320,6037228320,2017,608,552,90.790001,515,37
1400000US06037228410,6037228410,2017,536,495,92.349998,471,24
1400000US06037228420,6037228420,2017,1249,1216,97.360001,1110,106
1400000US06037228500,6037228500,2017,583,568,97.43,518,50
1400000US06037228600,6037228600,2017,2050,1849,90.199997,1770,79
1400000US06037228710,6037228710,2017,1168,1057,90.5,1010,47
1400000US06037228720,6037228720,2017,838,783,93.440002,739,44
1400000US06037228800,6037228800,2017,270,255,94.440002,252,3
1400000US06037229200,6037229200,2017,723,665,91.980003,645,20
1400000US06037229300,6037229300,2017,417,413,99.040001,383,30
1400000US06037229410,6037229410,2017,2979,2711,91,2599,112
1400000US06037229420,6037229420,2017,1829,1620,88.57,1542,78
1400000US06037231100,6037231100,2017,1848,1756,95.019997,1640,116
1400000US06037231220,6037231220,2017,1124,901,80.160004,755,146
1400000US06037231302,6037231302,2017,447,396,88.589996,375,21
1400000US06037231400,6037231400,2017,120,108,90,101,7
1400000US06037231500,6037231500,2017,389,363,93.32,317,46
1400000US06037231603,6037231603,2017,1390,1213,87.269997,1129,84
1400000US06037231710,6037231710,2017,507,466,91.910004,446,20
1400000US06037231720,6037231720,2017,232,218,93.970001,194,24
1400000US06037231800,6037231800,2017,728,673,92.449997,649,24
1400000US06037232110,6037232110,2017,1333,1213,91,1163,50
1400000US06037232200,6037232200,2017,1471,1325,90.07,1210,115
1400000US06037232300,6037232300,2017,185,179,96.760002,171,8
1400000US06037232401,6037232401,2017,831,775,93.260002,749,26
1400000US06037232402,6037232402,2017,80,74,92.5,64,10
1400000US06037232500,6037232500,2017,526,457,86.879997,422,35
1400000US06037234001,6037234001,2017,721,646,89.599998,601,45
1400000US06037234002,6037234002,2017,428,408,95.330002,391,17
1400000US06037234301,6037234301,2017,696,602,86.489998,564,38
1400000US06037234501,6037234501,2017,1219,1135,93.110001,1050,85
1400000US06037234502,6037234502,2017,624,577,92.470001,531,46
1400000US06037234600,6037234600,2017,2634,2287,86.830002,1999,288
1400000US06037234700,6037234700,2017,337,328,97.330002,300,28
1400000US06037234901,6037234901,2017,568,529,93.129997,508,21
1400000US06037235201,6037235201,2017,1177,1091,92.690002,992,99
1400000US06037236203,6037236203,2017,734,671,91.419998,601,70
1400000US06037236204,6037236204,2017,617,541,87.68,518,23
1400000US06037236400,6037236400,2017,213,189,88.730003,171,18
1400000US06037237101,6037237101,2017,3509,3068,87.43,2929,139
1400000US06037237102,6037237102,2017,533,479,89.870003,458,21
1400000US06037237300,6037237300,2017,526,410,77.949997,374,36
1400000US06037237500,6037237500,2017,634,538,84.860001,509,29
1400000US06037237600,6037237600,2017,814,739,90.790001,712,27
1400000US06037237800,6037237800,2017,559,499,89.269997,455,44
1400000US06037237900,6037237900,2017,530,440,83.019997,407,33
1400000US06037238000,6037238000,2017,724,659,91.019997,612,47
1400000US06037238200,6037238200,2017,445,395,88.760002,356,39
1400000US06037238320,6037238320,2017,1170,1053,90,920,133
1400000US06037238400,6037238400,2017,396,360,90.910004,349,11
1400000US06037239201,6037239201,2017,1055,1046,99.150002,1033,13
1400000US06037239320,6037239320,2017,1132,1037,91.610001,992,45
1400000US06037239330,6037239330,2017,846,775,91.610001,740,35
1400000US06037239502,6037239502,2017,3461,3169,91.559998,3009,160
1400000US06037239601,6037239601,2017,1060,977,92.169998,928,49
1400000US06037239802,6037239802,2017,972,884,90.949997,846,38
1400000US06037240010,6037240010,2017,1393,1240,89.019997,1166,74
1400000US06037240020,6037240020,2017,226,210,92.919998,188,22
1400000US06037240200,6037240200,2017,805,734,91.18,698,36
1400000US06037240301,6037240301,2017,812,774,95.32,757,17
1400000US06037240302,6037240302,2017,176,138,78.410004,137,1
1400000US06037240401,6037240401,2017,1472,1284,87.230003,1227,57
1400000US06037240500,6037240500,2017,1415,1365,96.470001,1266,99
1400000US06037240600,6037240600,2017,1018,947,93.029999,906,41
1400000US06037240700,6037240700,2017,567,508,89.589996,479,29
1400000US06037240902,6037240902,2017,2322,2219,95.559998,2095,124
1400000US06037241001,6037241001,2017,932,886,95.059998,818,68
1400000US06037241110,6037241110,2017,865,801,92.599998,767,34
1400000US06037241120,6037241120,2017,493,441,89.449997,428,13
1400000US06037241202,6037241202,2017,581,520,89.5,485,35
1400000US06037241400,6037241400,2017,600,560,93.330002,521,39
1400000US06037242000,6037242000,2017,389,371,95.370003,360,11
1400000US06037242100,6037242100,2017,969,886,91.43,825,61
1400000US06037242201,6037242201,2017,874,809,92.559998,777,32
1400000US06037242202,6037242202,2017,883,833,94.339996,774,59
1400000US06037242300,6037242300,2017,770,701,91.040001,656,45
1400000US06037242600,6037242600,2017,596,566,94.970001,549,17
1400000US06037242700,6037242700,2017,1390,1295,93.169998,1250,45
1400000US06037243001,6037243001,2017,497,484,97.379997,451,33
1400000US06037243002,6037243002,2017,453,418,92.269997,398,20
1400000US06037243100,6037243100,2017,570,525,92.110001,512,13
1400000US06037262200,6037262200,2017,911,154,16.9,102,52
1400000US06037262303,6037262303,2017,546,36,6.5900002,27,9
1400000US06037262604,6037262604,2017,524,44,8.3999996,41,3
1400000US06037262704,6037262704,2017,2907,858,29.51,666,192
1400000US06037262706,6037262706,2017,486,31,6.3800001,24,7
1400000US06037262802,6037262802,2017,2537,585,23.059999,464,121
1400000US06037264305,6037264305,2017,779,653,83.830002,513,140
1400000US06037265100,6037265100,2017,671,49,7.3000002,35,14
1400000US06037265601,6037265601,2017,1060,397,37.450001,319,78
1400000US06037267202,6037267202,2017,855,71,8.3000002,52,19
1400000US06037267300,6037267300,2017,307,227,73.940002,183,44
1400000US06037267404,6037267404,2017,1602,1204,75.160004,922,282
1400000US06037267406,6037267406,2017,207,165,79.709999,136,29
1400000US06037267600,6037267600,2017,817,185,22.639999,121,64
1400000US06037269000,6037269000,2017,553,182,32.91,144,38
1400000US06037269100,6037269100,2017,355,92,25.92,69,23
1400000US06037269300,6037269300,2017,493,43,8.7200003,31,12
1400000US06037269700,6037269700,2017,3164,2311,73.040001,1899,412
1400000US06037269907,6037269907,2017,342,279,81.580002,240,39
1400000US06037271200,6037271200,2017,463,113,24.41,78,35
1400000US06037271300,6037271300,2017,872,654,75,566,88
1400000US06037271400,6037271400,2017,309,141,45.630001,105,36
1400000US06037271500,6037271500,2017,563,84,14.92,69,15
1400000US06037271702,6037271702,2017,576,141,24.48,104,37
1400000US06037271703,6037271703,2017,1382,897,64.910004,661,236
1400000US06037271801,6037271801,2017,321,266,82.870003,225,41
1400000US06037272100,6037272100,2017,950,701,73.790001,593,108
1400000US06037272302,6037272302,2017,26,18,69.230003,11,7
1400000US06037273200,6037273200,2017,1183,616,52.07,504,112
1400000US06037273403,6037273403,2017,369,311,84.279999,272,39
1400000US06037273800,6037273800,2017,2520,1575,62.5,1288,287
1400000US06037274202,6037274202,2017,388,314,80.93,259,55
1400000US06037275200,6037275200,2017,587,572,97.440002,538,34
1400000US06037275311,6037275311,2017,1510,652,43.18,564,88
1400000US06037275400,6037275400,2017,260,160,61.540001,129,31
1400000US06037275500,6037275500,2017,719,547,76.080002,495,52
1400000US06037275603,6037275603,2017,262,124,47.330002,82,42
1400000US06037275604,6037275604,2017,576,121,21.01,91,30
1400000US06037275605,6037275605,2017,433,347,80.139999,284,63
1400000US06037276000,6037276000,2017,321,210,65.419998,160,50
1400000US06037276400,6037276400,2017,344,116,33.720001,80,36
1400000US06037276605,6037276605,2017,482,293,60.790001,210,83
1400000US06037276607,6037276607,2017,386,284,73.580002,223,61
1400000US06037276608,6037276608,2017,1156,779,67.389999,607,172
1400000US06037277000,6037277000,2017,1632,770,47.18,588,182
1400000US06037277100,6037277100,2017,409,71,17.360001,39,32
1400000US06037291120,6037291120,2017,777,699,89.959999,616,83
1400000US06037291210,6037291210,2017,556,495,89.029999,442,53
1400000US06037291220,6037291220,2017,355,302,85.07,245,57
1400000US06037291300,6037291300,2017,1000,733,73.300003,646,87
1400000US06037293204,6037293204,2017,518,441,85.139999,376,65
1400000US06037293302,6037293302,2017,3171,2673,84.300003,2194,479
1400000US06037293304,6037293304,2017,605,523,86.449997,466,57
1400000US06037294110,6037294110,2017,3097,2738,88.410004,2320,418
1400000US06037294200,6037294200,2017,1434,1298,90.519997,1151,147
1400000US06037294302,6037294302,2017,443,295,66.589996,197,98
1400000US06037294410,6037294410,2017,363,329,90.629997,309,20
1400000US06037294510,6037294510,2017,832,746,89.660004,675,71
1400000US06037294520,6037294520,2017,522,497,95.209999,436,61
1400000US06037294610,6037294610,2017,1157,1020,88.160004,910,110
1400000US06037294620,6037294620,2017,791,743,93.93,651,92
1400000US06037294830,6037294830,2017,625,547,87.519997,518,29
1400000US06037294900,6037294900,2017,633,548,86.57,501,47
1400000US06037295103,6037295103,2017,809,463,57.23,338,125
1400000US06037296220,6037296220,2017,937,571,60.939999,450,121
1400000US06037296300,6037296300,2017,710,431,60.700001,313,118
1400000US06037296401,6037296401,2017,520,347,66.730003,277,70
1400000US06037296500,6037296500,2017,905,809,89.389999,730,79
1400000US06037296600,6037296600,2017,395,341,86.330002,321,20
1400000US06037296901,6037296901,2017,4047,2847,70.349998,2277,570
1400000US06037297110,6037297110,2017,279,207,74.190002,177,30
1400000US06037297120,6037297120,2017,516,453,87.790001,415,38
1400000US06037297202,6037297202,2017,534,446,83.519997,363,83
1400000US06037297400,6037297400,2017,472,204,43.220001,144,60
1400000US06037297501,6037297501,2017,383,139,36.290001,99,40
1400000US06037297601,6037297601,2017,64,55,85.940002,49,6
1400000US06037297602,6037297602,2017,334,221,66.169998,152,69
1400000US06037300200,6037300200,2017,2653,460,17.34,350,110
1400000US06037300301,6037300301,2017,2116,731,34.549999,544,187
1400000US06037300400,6037300400,2017,480,129,26.879999,93,36
1400000US06037300501,6037300501,2017,3166,641,20.25,487,154
1400000US06037300602,6037300602,2017,670,123,18.360001,82,41
1400000US06037300800,6037300800,2017,822,201,24.450001,155,46
1400000US06037300902,6037300902,2017,565,189,33.450001,152,37
1400000US06037301000,6037301000,2017,1232,736,59.740002,617,119
1400000US06037301206,6037301206,2017,3884,2155,55.48,1637,518
1400000US06037301400,6037301400,2017,792,421,53.16,350,71
1400000US06037301502,6037301502,2017,660,502,76.059998,402,100
1400000US06037301602,6037301602,2017,646,101,15.63,77,24
1400000US06037301801,6037301801,2017,570,428,75.089996,340,88
1400000US06037301902,6037301902,2017,909,574,63.150002,477,97
1400000US06037302002,6037302002,2017,172,123,71.510002,99,24
1400000US06037302004,6037302004,2017,465,383,82.370003,334,49
1400000US06037302104,6037302104,2017,2241,1515,67.599998,1272,243
1400000US06037302302,6037302302,2017,912,578,63.380001,465,113
1400000US06037302504,6037302504,2017,2300,1868,81.220001,1606,262
1400000US06037302505,6037302505,2017,385,326,84.68,284,42
1400000US06037310201,6037310201,2017,596,192,32.209999,151,41
1400000US06037310300,6037310300,2017,2152,620,28.809999,488,132
1400000US06037310601,6037310601,2017,477,269,56.389999,219,50
1400000US06037310602,6037310602,2017,2528,880,34.810001,730,150
1400000US06037310703,6037310703,2017,760,339,44.610001,275,64
1400000US06037310705,6037310705,2017,24,14,58.330002,11,3
1400000US06037310800,6037310800,2017,2956,886,29.969999,661,225
1400000US06037310900,6037310900,2017,1311,658,50.189999,521,137
1400000US06037311000,6037311000,2017,1010,405,40.099998,307,98
1400000US06037311100,6037311100,2017,1007,371,36.84,298,73
1400000US06037311200,6037311200,2017,36,8,22.219999,6,2
1400000US06037311500,6037311500,2017,1233,192,15.57,150,42
1400000US06037311700,6037311700,2017,1065,362,33.990002,293,69
1400000US06037311802,6037311802,2017,455,212,46.59,174,38
1400000US06037320101,6037320101,2017,561,440,78.43,356,84
1400000US06037320102,6037320102,2017,1860,1603,86.18,1334,269
1400000US06037320201,6037320201,2017,1591,1385,87.050003,1145,240
1400000US06037320202,6037320202,2017,586,557,95.050003,439,118
1400000US06037320300,6037320300,2017,2027,1768,87.220001,1518,250
1400000US06037400205,6037400205,2017,69,69,100,69,0
1400000US06037400208,6037400208,2017,594,52,8.75,42,10
1400000US06037400304,6037400304,2017,973,459,47.169998,365,94
1400000US06037400402,6037400402,2017,2483,541,21.790001,405,136
1400000US06037400403,6037400403,2017,53,53,100,53,0
1400000US06037400404,6037400404,2017,602,89,14.78,71,18
1400000US06037400501,6037400501,2017,962,148,15.38,115,33
1400000US06037400602,6037400602,2017,676,454,67.160004,358,96
1400000US06037400605,6037400605,2017,277,235,84.839996,204,31
1400000US06037400801,6037400801,2017,2106,862,40.93,666,196
1400000US06037401001,6037401001,2017,643,130,20.219999,93,37
1400000US06037401202,6037401202,2017,908,376,41.41,301,75
1400000US06037401203,6037401203,2017,116,57,49.139999,52,5
1400000US06037401311,6037401311,2017,1161,333,28.68,232,101
1400000US06037401312,6037401312,2017,2283,798,34.950001,598,200
1400000US06037401601,6037401601,2017,500,90,18,77,13
1400000US06037401602,6037401602,2017,2711,948,34.970001,732,216
1400000US06037401705,6037401705,2017,556,255,45.860001,225,30
1400000US06037401707,6037401707,2017,357,314,87.959999,273,41
1400000US06037401801,6037401801,2017,648,111,17.129999,83,28
1400000US06037401802,6037401802,2017,3039,935,30.77,716,219
1400000US06037401902,6037401902,2017,2020,729,36.09,595,134
1400000US06037402001,6037402001,2017,335,260,77.610001,204,56
1400000US06037402002,6037402002,2017,361,204,56.509998,161,43
1400000US06037402101,6037402101,2017,337,311,92.279999,285,26
1400000US06037402102,6037402102,2017,2208,1915,86.730003,1637,278
1400000US06037402200,6037402200,2017,276,220,79.709999,198,22
1400000US06037402301,6037402301,2017,1299,1160,89.300003,1011,149
1400000US06037402303,6037402303,2017,393,370,94.150002,335,35
1400000US06037402403,6037402403,2017,950,511,53.790001,398,113
1400000US06037402405,6037402405,2017,999,886,88.690002,752,134
1400000US06037402406,6037402406,2017,1066,999,93.709999,887,112
1400000US06037402501,6037402501,2017,1211,1176,97.110001,1062,114
1400000US06037402503,6037402503,2017,944,885,93.75,774,111
1400000US06037402504,6037402504,2017,537,517,96.279999,455,62
1400000US06037402601,6037402601,2017,640,603,94.220001,537,66
1400000US06037402702,6037402702,2017,999,901,90.190002,797,104
1400000US06037402703,6037402703,2017,301,268,89.040001,223,45
1400000US06037402705,6037402705,2017,582,558,95.879997,526,32
1400000US06037402706,6037402706,2017,240,222,92.5,198,24
1400000US06037402902,6037402902,2017,710,671,94.510002,588,83
1400000US06037402903,6037402903,2017,1658,1569,94.629997,1376,193
1400000US06037403000,6037403000,2017,3148,2845,90.370003,2413,432
1400000US06037403316,6037403316,2017,1032,620,60.080002,485,135
1400000US06037403317,6037403317,2017,2120,1141,53.82,883,258
1400000US06037403318,6037403318,2017,528,344,65.150002,279,65
1400000US06037403320,6037403320,2017,372,143,38.439999,113,30
1400000US06037403321,6037403321,2017,367,232,63.220001,184,48
1400000US06037403323,6037403323,2017,1743,186,10.67,133,53
1400000US06037403324,6037403324,2017,635,70,11.02,53,17
1400000US06037403325,6037403325,2017,4254,445,10.46,318,127
1400000US06037403326,6037403326,2017,664,119,17.92,83,36
1400000US06037403327,6037403327,2017,401,225,56.110001,178,47
1400000US06037403401,6037403401,2017,475,107,22.530001,85,22
1400000US06037403402,6037403402,2017,3161,486,15.37,361,125
1400000US06037403404,6037403404,2017,1296,208,16.049999,140,68
1400000US06037403407,6037403407,2017,596,55,9.2299995,37,18
1400000US06037403408,6037403408,2017,1045,418,40,293,125
1400000US06037403409,6037403409,2017,587,107,18.23,70,37
1400000US06037403601,6037403601,2017,818,532,65.040001,408,124
1400000US06037403702,6037403702,2017,1978,1053,53.240002,864,189
1400000US06037403703,6037403703,2017,430,274,63.720001,225,49
1400000US06037403722,6037403722,2017,712,393,55.200001,329,64
1400000US06037403801,6037403801,2017,1198,824,68.779999,708,116
1400000US06037403901,6037403901,2017,45,21,46.669998,17,4
1400000US06037403902,6037403902,2017,452,248,54.869999,209,39
1400000US06037404000,6037404000,2017,816,682,83.580002,576,106
1400000US06037404100,6037404100,2017,479,405,84.550003,348,57
1400000US06037404201,6037404201,2017,2149,1738,80.870003,1438,300
1400000US06037404203,6037404203,2017,228,177,77.629997,153,24
1400000US06037404401,6037404401,2017,745,582,78.120003,476,106
1400000US06037404402,6037404402,2017,721,606,84.050003,511,95
1400000US06037404503,6037404503,2017,272,237,87.129997,201,36
1400000US06037404504,6037404504,2017,447,401,89.709999,369,32
1400000US06037404600,6037404600,2017,1331,976,73.330002,762,214
1400000US06037404701,6037404701,2017,938,866,92.32,739,127
1400000US06037404702,6037404702,2017,718,634,88.300003,561,73
1400000US06037404804,6037404804,2017,2705,2314,85.550003,1910,404
1400000US06037404805,6037404805,2017,529,484,91.489998,412,72
1400000US06037404806,6037404806,2017,1118,994,88.910004,847,147
1400000US06037404901,6037404901,2017,576,479,83.160004,377,102
1400000US06037404903,6037404903,2017,518,451,87.07,391,60
1400000US06037405001,6037405001,2017,986,864,87.629997,732,132
1400000US06037405002,6037405002,2017,397,374,94.209999,337,37
1400000US06037405101,6037405101,2017,1716,1499,87.349998,1260,239
1400000US06037405201,6037405201,2017,2432,2078,85.440002,1730,348
1400000US06037405202,6037405202,2017,734,653,88.959999,574,79
1400000US06037405302,6037405302,2017,511,396,77.5,334,62
1400000US06037405400,6037405400,2017,238,196,82.349998,164,32
1400000US06037405600,6037405600,2017,985,720,73.099998,562,158
1400000US06037405701,6037405701,2017,1233,973,78.910004,795,178
1400000US06037405702,6037405702,2017,1290,894,69.300003,722,172
1400000US06037405800,6037405800,2017,1850,1374,74.269997,1127,247
1400000US06037406000,6037406000,2017,1907,1391,72.940002,1101,290
1400000US06037406103,6037406103,2017,604,402,66.559998,343,59
1400000US06037406201,6037406201,2017,1346,983,73.029999,774,209
1400000US06037406300,6037406300,2017,2262,1143,50.529999,889,254
1400000US06037406413,6037406413,2017,1344,857,63.759998,684,173
1400000US06037406601,6037406601,2017,3858,2570,66.610001,2015,555
1400000US06037406602,6037406602,2017,360,280,77.779999,220,60
1400000US06037406701,6037406701,2017,377,291,77.190002,221,70
1400000US06037406702,6037406702,2017,244,201,82.379997,175,26
1400000US06037406801,6037406801,2017,1929,1311,67.959999,1038,273
1400000US06037406903,6037406903,2017,2292,1505,65.660004,1169,336
1400000US06037407001,6037407001,2017,399,361,90.480003,318,43
1400000US06037407002,6037407002,2017,613,562,91.68,510,52
1400000US06037407101,6037407101,2017,1924,1663,86.43,1461,202
1400000US06037407201,6037407201,2017,348,314,90.230003,274,40
1400000US06037407301,6037407301,2017,374,338,90.370003,299,39
1400000US06037407302,6037407302,2017,1220,1123,92.050003,970,153
1400000US06037407501,6037407501,2017,899,738,82.089996,627,111
1400000US06037407502,6037407502,2017,653,571,87.440002,511,60
1400000US06037407602,6037407602,2017,683,619,90.629997,537,82
1400000US06037407701,6037407701,2017,523,506,96.75,467,39
1400000US06037407702,6037407702,2017,1513,1295,85.589996,1150,145
1400000US06037407801,6037407801,2017,584,512,87.669998,454,58
1400000US06037407802,6037407802,2017,1420,1202,84.650002,1042,160
1400000US06037407901,6037407901,2017,558,467,83.690002,415,52
1400000US06037408003,6037408003,2017,92,64,69.57,54,10
1400000US06037408135,6037408135,2017,590,535,90.68,472,63
1400000US06037408136,6037408136,2017,335,271,80.900002,223,48
1400000US06037408137,6037408137,2017,791,630,79.650002,484,146
1400000US06037408138,6037408138,2017,441,423,95.919998,373,50
1400000US06037408139,6037408139,2017,485,452,93.199997,401,51
1400000US06037408140,6037408140,2017,592,549,92.739998,492,57
1400000US06037408141,6037408141,2017,2444,2044,83.629997,1717,327
1400000US06037408212,6037408212,2017,669,352,52.619999,261,91
1400000US06037408213,6037408213,2017,366,322,87.980003,270,52
1400000US06037408301,6037408301,2017,472,443,93.860001,393,50
1400000US06037408302,6037408302,2017,634,409,64.510002,327,82
1400000US06037408401,6037408401,2017,12,6,50,5,1
1400000US06037408402,6037408402,2017,1057,848,80.230003,710,138
1400000US06037408503,6037408503,2017,891,417,46.799999,315,102
1400000US06037408504,6037408504,2017,609,348,57.139999,281,67
1400000US06037408505,6037408505,2017,2116,1425,67.339996,1176,249
1400000US06037408623,6037408623,2017,1942,976,50.259998,731,245
1400000US06037408624,6037408624,2017,272,220,80.879997,182,38
1400000US06037408625,6037408625,2017,1663,631,37.939999,463,168
1400000US06037408631,6037408631,2017,579,415,71.68,357,58
1400000US06037408705,6037408705,2017,3149,1767,56.110001,1325,442
1400000US06037408707,6037408707,2017,878,145,16.51,110,35
1400000US06037408722,6037408722,2017,673,341,50.669998,251,90
1400000US06037408724,6037408724,2017,517,455,88.010002,414,41
1400000US06037408725,6037408725,2017,749,488,65.150002,396,92
1400000US06037408900,6037408900,2017,1799,685,38.080002,522,163
1400000US06037409000,6037409000,2017,517,451,87.230003,398,53
1400000US06037409100,6037409100,2017,190,148,77.889999,137,11
1400000US06037430003,6037430003,2017,376,218,57.98,156,62
1400000US06037430005,6037430005,2017,324,276,85.190002,228,48
1400000US06037430101,6037430101,2017,1718,1197,69.669998,927,270
1400000US06037430102,6037430102,2017,330,277,83.940002,234,43
1400000US06037430200,6037430200,2017,492,284,57.720001,204,80
1400000US06037430302,6037430302,2017,538,245,45.540001,189,56
1400000US06037430400,6037430400,2017,1458,204,13.99,126,78
1400000US06037430502,6037430502,2017,1126,222,19.719999,172,50
1400000US06037430701,6037430701,2017,598,137,22.91,104,33
1400000US06037430721,6037430721,2017,3307,698,21.110001,442,256
1400000US06037430801,6037430801,2017,825,172,20.85,124,48
1400000US06037430802,6037430802,2017,1331,326,24.49,223,103
1400000US06037431002,6037431002,2017,590,377,63.900002,301,76
1400000US06037431003,6037431003,2017,1591,812,51.040001,606,206
1400000US06037431004,6037431004,2017,1744,1056,60.549999,821,235
1400000US06037431100,6037431100,2017,573,389,67.889999,291,98
1400000US06037431200,6037431200,2017,367,333,90.739998,278,55
1400000US06037431400,6037431400,2017,382,276,72.25,220,56
1400000US06037431501,6037431501,2017,375,260,69.330002,211,49
1400000US06037431502,6037431502,2017,767,597,77.839996,508,89
1400000US06037431600,6037431600,2017,470,114,24.26,74,40
1400000US06037431701,6037431701,2017,1406,288,20.48,182,106
1400000US06037431800,6037431800,2017,2071,806,38.919998,524,282
1400000US06037431900,6037431900,2017,1039,391,37.630001,272,119
1400000US06037432002,6037432002,2017,497,212,42.66,133,79
1400000US06037432102,6037432102,2017,587,268,45.66,193,75
1400000US06037432201,6037432201,2017,498,363,72.889999,271,92
1400000US06037432202,6037432202,2017,2696,2201,81.639999,1623,578
1400000US06037432300,6037432300,2017,884,802,90.720001,705,97
1400000US06037432401,6037432401,2017,3047,2635,86.480003,2160,475
1400000US06037432402,6037432402,2017,514,477,92.800003,427,50
1400000US06037432501,6037432501,2017,417,347,83.209999,299,48
1400000US06037432602,6037432602,2017,1327,1136,85.610001,998,138
1400000US06037432801,6037432801,2017,610,592,97.050003,567,25
1400000US06037432902,6037432902,2017,422,345,81.75,279,66
1400000US06037433103,6037433103,2017,401,386,96.260002,351,35
1400000US06037433200,6037433200,2017,3057,2854,93.360001,2515,339
1400000US06037433302,6037433302,2017,853,794,93.080002,711,83
1400000US06037433305,6037433305,2017,587,544,92.669998,498,46
1400000US06037433306,6037433306,2017,441,410,92.970001,383,27
1400000US06037433307,6037433307,2017,705,623,88.370003,552,71
1400000US06037433505,6037433505,2017,1293,1245,96.290001,1182,63
1400000US06037433803,6037433803,2017,1936,1706,88.120003,1435,271
1400000US06037433804,6037433804,2017,1182,1002,84.769997,923,79
1400000US06037433901,6037433901,2017,489,459,93.870003,425,34
1400000US06037433903,6037433903,2017,1324,1226,92.599998,1138,88
1400000US06037434001,6037434001,2017,1339,1254,93.650002,1093,161
1400000US06037434003,6037434003,2017,1249,1180,94.480003,1042,138
1400000US06037434100,6037434100,2017,493,421,85.400002,354,67
1400000US06037460002,6037460002,2017,622,242,38.91,174,68
1400000US06037460101,6037460101,2017,438,45,10.27,31,14
1400000US06037460200,6037460200,2017,181,106,58.560001,80,26
1400000US06037460301,6037460301,2017,450,114,25.33,91,23
1400000US06037460302,6037460302,2017,711,320,45.009998,250,70
1400000US06037460501,6037460501,2017,715,8,1.12,6,2
1400000US06037460502,6037460502,2017,633,7,1.11,3,4
1400000US06037460601,6037460601,2017,669,12,1.79,9,3
1400000US06037460700,6037460700,2017,2024,34,1.6799999,23,11
1400000US06037460900,6037460900,2017,1018,784,77.010002,695,89
1400000US06037461000,6037461000,2017,547,402,73.489998,357,45
1400000US06037461100,6037461100,2017,256,216,84.379997,202,14
1400000US06037461200,6037461200,2017,436,339,77.75,303,36
1400000US06037461300,6037461300,2017,442,256,57.919998,195,61
1400000US06037461400,6037461400,2017,496,389,78.43,327,62
1400000US06037461502,6037461502,2017,1089,920,84.480003,843,77
1400000US06037461700,6037461700,2017,315,251,79.68,224,27
1400000US06037462100,6037462100,2017,440,405,92.050003,372,33
1400000US06037462500,6037462500,2017,2273,1354,59.57,1090,264
1400000US06037462600,6037462600,2017,1987,1146,57.669998,903,243
1400000US06037462700,6037462700,2017,385,334,86.75,271,63
1400000US06037462900,6037462900,2017,142,131,92.25,118,13
1400000US06037463000,6037463000,2017,2398,1714,71.480003,1435,279
1400000US06037463200,6037463200,2017,1127,810,71.870003,685,125
1400000US06037463300,6037463300,2017,598,281,46.990002,188,93
1400000US06037463601,6037463601,2017,1120,703,62.77,608,95
1400000US06037463800,6037463800,2017,468,161,34.400002,111,50
1400000US06037464000,6037464000,2017,1053,624,59.259998,527,97
1400000US06037464101,6037464101,2017,1313,36,2.74,27,9
1400000US06037464200,6037464200,2017,1088,37,3.4000001,29,8
1400000US06037480002,6037480002,2017,947,134,14.15,87,47
1400000US06037480012,6037480012,2017,1596,588,36.84,380,208
1400000US06037480201,6037480201,2017,379,150,39.580002,114,36
1400000US06037480202,6037480202,2017,487,233,47.84,180,53
1400000US06037480302,6037480302,2017,452,322,71.239998,251,71
1400000US06037480304,6037480304,2017,3096,2233,72.129997,1716,517
1400000US06037480400,6037480400,2017,1710,1042,60.939999,759,283
1400000US06037480500,6037480500,2017,1924,277,14.4,182,95
1400000US06037480702,6037480702,2017,622,72,11.58,41,31
1400000US06037480703,6037480703,2017,702,58,8.2600002,43,15
1400000US06037480704,6037480704,2017,1452,216,14.88,122,94
1400000US06037480803,6037480803,2017,454,325,71.589996,239,86
1400000US06037480804,6037480804,2017,736,511,69.43,379,132
1400000US06037480901,6037480901,2017,182,104,57.139999,94,10
1400000US06037480903,6037480903,2017,644,444,68.940002,346,98
1400000US06037481101,6037481101,2017,811,583,71.889999,460,123
1400000US06037481102,6037481102,2017,40,28,70,20,8
1400000US06037481103,6037481103,2017,2192,1666,76,1320,346
1400000US06037481203,6037481203,2017,1569,931,59.34,750,181
1400000US06037481300,6037481300,2017,556,448,80.580002,325,123
1400000US06037481401,6037481401,2017,585,403,68.889999,290,113
1400000US06037481403,6037481403,2017,373,315,84.449997,272,43
1400000US06037481404,6037481404,2017,1774,941,53.040001,683,258
1400000US06037481500,6037481500,2017,2272,1196,52.639999,865,331
1400000US06037481606,6037481606,2017,857,653,76.199997,518,135
1400000US06037481901,6037481901,2017,569,405,71.18,307,98
1400000US06037482001,6037482001,2017,1026,527,51.360001,390,137
1400000US06037482002,6037482002,2017,947,384,40.549999,282,102
1400000US06037482101,6037482101,2017,876,658,75.110001,513,145
1400000US06037482102,6037482102,2017,789,418,52.98,296,122
1400000US06037482202,6037482202,2017,479,366,76.410004,307,59
1400000US06037482304,6037482304,2017,513,451,87.910004,384,67
1400000US06037482401,6037482401,2017,403,348,86.349998,295,53
1400000US06037482403,6037482403,2017,1370,1180,86.129997,1005,175
1400000US06037482502,6037482502,2017,1224,997,81.449997,852,145
1400000US06037482522,6037482522,2017,393,243,61.830002,190,53
1400000US06037482600,6037482600,2017,392,259,66.07,214,45
1400000US06037482701,6037482701,2017,543,404,74.400002,336,68
1400000US06037482801,6037482801,2017,920,664,72.169998,545,119
1400000US06037500202,6037500202,2017,3977,1936,48.68,1346,590
1400000US06037500203,6037500203,2017,559,89,15.92,66,23
1400000US06037500300,6037500300,2017,439,313,71.300003,249,64
1400000US06037500402,6037500402,2017,701,505,72.040001,434,71
1400000US06037500404,6037500404,2017,387,279,72.089996,238,41
1400000US06037500600,6037500600,2017,805,652,80.989998,556,96
1400000US06037500700,6037500700,2017,429,336,78.32,267,69
1400000US06037500800,6037500800,2017,2998,2163,72.150002,1762,401
1400000US06037500900,6037500900,2017,546,397,72.709999,361,36
1400000US06037501001,6037501001,2017,340,293,86.18,245,48
1400000US06037501002,6037501002,2017,1192,1007,84.480003,849,158
1400000US06037501200,6037501200,2017,375,303,80.800003,261,42
1400000US06037501302,6037501302,2017,1581,1258,79.57,1063,195
1400000US06037501400,6037501400,2017,1901,1394,73.330002,1145,249
1400000US06037501600,6037501600,2017,451,349,77.379997,290,59
1400000US06037501700,6037501700,2017,770,230,29.870001,187,43
1400000US06037501804,6037501804,2017,411,375,91.239998,321,54
1400000US06037502003,6037502003,2017,426,363,85.209999,317,46
1400000US06037502005,6037502005,2017,632,429,67.879997,344,85
1400000US06037502200,6037502200,2017,523,404,77.25,341,63
1400000US06037502303,6037502303,2017,2608,2249,86.230003,1875,374
1400000US06037502401,6037502401,2017,1399,1024,73.199997,839,185
1400000US06037502500,6037502500,2017,71,55,77.459999,43,12
1400000US06037502602,6037502602,2017,432,344,79.629997,296,48
1400000US06037502603,6037502603,2017,615,429,69.760002,344,85
1400000US06037502604,6037502604,2017,452,351,77.650002,275,76
1400000US06037502700,6037502700,2017,837,617,73.720001,463,154
1400000US06037502801,6037502801,2017,3708,2606,70.279999,1714,892
1400000US06037503103,6037503103,2017,504,460,91.269997,401,59
1400000US06037503105,6037503105,2017,619,555,89.660004,459,96
1400000US06037503201,6037503201,2017,395,271,68.610001,215,56
1400000US06037503202,6037503202,2017,375,320,85.330002,256,64
1400000US06037503302,6037503302,2017,3336,2439,73.110001,1907,532
1400000US06037503402,6037503402,2017,622,170,27.33,125,45
1400000US06037503501,6037503501,2017,1070,655,61.209999,520,135
1400000US06037503502,6037503502,2017,681,450,66.080002,362,88
1400000US06037503602,6037503602,2017,2465,1177,47.75,971,206
1400000US06037503701,6037503701,2017,1768,740,41.860001,551,189
1400000US06037503705,6037503705,2017,238,107,44.959999,88,19
1400000US06037503801,6037503801,2017,1199,556,46.369999,492,64
1400000US06037503802,6037503802,2017,470,218,46.380001,177,41
1400000US06037503902,6037503902,2017,597,247,41.369999,210,37
1400000US06037504002,6037504002,2017,1465,706,48.189999,581,125
1400000US06037504101,6037504101,2017,341,261,76.540001,242,19
1400000US06037504200,6037504200,2017,1997,1621,81.169998,1388,233
1400000US06037530005,6037530005,2017,2744,1677,61.119999,1404,273
1400000US06037530007,6037530007,2017,2030,1676,82.559998,1469,207
1400000US06037530101,6037530101,2017,421,400,95.010002,367,33
1400000US06037530102,6037530102,2017,4433,3819,86.150002,3300,519
1400000US06037530202,6037530202,2017,824,754,91.5,682,72
1400000US06037530203,6037530203,2017,613,541,88.25,483,58
1400000US06037530301,6037530301,2017,3626,3228,89.019997,2807,421
1400000US06037530400,6037530400,2017,1828,1564,85.559998,1286,278
1400000US06037530500,6037530500,2017,719,637,88.599998,566,71
1400000US06037530603,6037530603,2017,759,624,82.209999,548,76
1400000US06037530700,6037530700,2017,570,476,83.510002,398,78
1400000US06037530801,6037530801,2017,475,436,91.790001,398,38
1400000US06037530902,6037530902,2017,696,633,90.949997,579,54
1400000US06037531000,6037531000,2017,2941,2668,90.720001,2449,219
1400000US06037531101,6037531101,2017,3008,2519,83.739998,2291,228
1400000US06037531102,6037531102,2017,1075,1004,93.400002,918,86
1400000US06037531201,6037531201,2017,863,747,86.559998,686,61
1400000US06037531202,6037531202,2017,163,144,88.339996,131,13
1400000US06037531302,6037531302,2017,1195,1077,90.129997,965,112
1400000US06037531502,6037531502,2017,999,889,88.989998,816,73
1400000US06037531503,6037531503,2017,597,552,92.459999,499,53
1400000US06037531603,6037531603,2017,1397,1272,91.050003,1129,143
1400000US06037531604,6037531604,2017,57,54,94.739998,53,1
1400000US06037531701,6037531701,2017,550,483,87.82,388,95
1400000US06037531702,6037531702,2017,598,520,86.959999,495,25
1400000US06037531800,6037531800,2017,793,667,84.110001,630,37
1400000US06037531902,6037531902,2017,549,474,86.339996,434,40
1400000US06037532002,6037532002,2017,565,429,75.93,353,76
1400000US06037532101,6037532101,2017,68,56,82.349998,50,6
1400000US06037532102,6037532102,2017,941,847,90.010002,776,71
1400000US06037532200,6037532200,2017,248,170,68.550003,161,9
1400000US06037532302,6037532302,2017,495,391,78.989998,346,45
1400000US06037532303,6037532303,2017,804,658,81.839996,521,137
1400000US06037532500,6037532500,2017,3253,2911,89.489998,2599,312
1400000US06037532605,6037532605,2017,427,401,93.910004,349,52
1400000US06037532607,6037532607,2017,1974,1767,89.510002,1570,197
1400000US06037532700,6037532700,2017,954,901,94.440002,839,62
1400000US06037532800,6037532800,2017,2671,2431,91.010002,2299,132
1400000US06037532900,6037532900,2017,1911,1790,93.669998,1671,119
1400000US06037533103,6037533103,2017,3039,2789,91.769997,2502,287
1400000US06037533108,6037533108,2017,2678,2413,90.099998,2187,226
1400000US06037533201,6037533201,2017,590,536,90.849998,465,71
1400000US06037533204,6037533204,2017,595,519,87.230003,466,53
1400000US06037533402,6037533402,2017,1529,1387,90.709999,1224,163
1400000US06037533403,6037533403,2017,1785,1586,88.849998,1364,222
1400000US06037533501,6037533501,2017,1763,1598,90.639999,1394,204
1400000US06037533504,6037533504,2017,833,744,89.32,638,106
1400000US06037533601,6037533601,2017,961,845,87.93,732,113
1400000US06037533602,6037533602,2017,2645,2369,89.57,2086,283
1400000US06037533603,6037533603,2017,2868,2567,89.5,2215,352
1400000US06037533703,6037533703,2017,637,559,87.760002,487,72
1400000US06037533804,6037533804,2017,714,601,84.169998,532,69
1400000US06037533901,6037533901,2017,3726,3252,87.279999,2832,420
1400000US06037533902,6037533902,2017,753,593,78.75,558,35
1400000US06037534001,6037534001,2017,848,760,89.620003,695,65
1400000US06037534002,6037534002,2017,971,818,84.239998,744,74
1400000US06037534102,6037534102,2017,1141,992,86.940002,920,72
1400000US06037534201,6037534201,2017,991,885,89.300003,827,58
1400000US06037534302,6037534302,2017,504,456,90.480003,421,35
1400000US06037534404,6037534404,2017,1389,1237,89.059998,1102,135
1400000US06037534405,6037534405,2017,1718,1519,88.419998,1385,134
1400000US06037534406,6037534406,2017,1316,1141,86.699997,1031,110
1400000US06037534501,6037534501,2017,1075,973,90.510002,835,138
1400000US06037534803,6037534803,2017,734,664,90.459999,594,70
1400000US06037534804,6037534804,2017,461,444,96.309998,403,41
1400000US06037534900,6037534900,2017,2456,2234,90.959999,1939,295
1400000US06037535001,6037535001,2017,1782,1620,90.910004,1534,86
1400000US06037535101,6037535101,2017,2482,2333,94,2181,152
1400000US06037535102,6037535102,2017,713,674,94.529999,629,45
1400000US06037535300,6037535300,2017,1143,1060,92.739998,964,96
1400000US06037535501,6037535501,2017,567,514,90.650002,462,52
1400000US06037535603,6037535603,2017,553,476,86.080002,418,58
1400000US06037535604,6037535604,2017,557,518,93,462,56
1400000US06037535605,6037535605,2017,759,637,83.93,569,68
1400000US06037535607,6037535607,2017,4070,3680,90.419998,3223,457
1400000US06037535701,6037535701,2017,715,633,88.529999,568,65
1400000US06037535702,6037535702,2017,3530,3055,86.540001,2604,451
1400000US06037535803,6037535803,2017,439,386,87.93,344,42
1400000US06037535901,6037535901,2017,1742,1493,85.709999,1223,270
1400000US06037536000,6037536000,2017,2809,2457,87.470001,2087,370
1400000US06037536103,6037536103,2017,664,550,82.830002,468,82
1400000US06037536104,6037536104,2017,1867,1675,89.720001,1368,307
1400000US06037536201,6037536201,2017,1037,924,89.099998,792,132
1400000US06037540000,6037540000,2017,2711,2473,91.220001,2376,97
1400000US06037540101,6037540101,2017,3295,3039,92.230003,2920,119
1400000US06037540102,6037540102,2017,28,22,78.57,22,0
1400000US06037540202,6037540202,2017,1968,1862,94.610001,1708,154
1400000US06037540203,6037540203,2017,618,585,94.660004,522,63
1400000US06037540300,6037540300,2017,499,475,95.190002,437,38
1400000US06037540400,6037540400,2017,349,327,93.699997,311,16
1400000US06037540502,6037540502,2017,768,742,96.610001,698,44
1400000US06037540600,6037540600,2017,541,421,77.82,398,23
1400000US06037540700,6037540700,2017,2613,2133,81.629997,1876,257
1400000US06037540800,6037540800,2017,1515,1428,94.260002,1315,113
1400000US06037540901,6037540901,2017,723,655,90.589996,598,57
1400000US06037540902,6037540902,2017,461,362,78.519997,328,34
1400000US06037541003,6037541003,2017,514,410,79.769997,340,70
1400000US06037541100,6037541100,2017,423,334,78.959999,316,18
1400000US06037541200,6037541200,2017,921,763,82.839996,722,41
1400000US06037541300,6037541300,2017,1290,979,75.889999,924,55
1400000US06037541401,6037541401,2017,516,422,81.779999,391,31
1400000US06037541500,6037541500,2017,800,670,83.75,627,43
1400000US06037541603,6037541603,2017,890,809,90.900002,750,59
1400000US06037541605,6037541605,2017,648,496,76.540001,482,14
1400000US06037541700,6037541700,2017,3552,3329,93.720001,3070,259
1400000US06037541802,6037541802,2017,685,634,92.550003,581,53
1400000US06037542000,6037542000,2017,1589,1206,75.900002,1164,42
1400000US06037542104,6037542104,2017,659,589,89.379997,559,30
1400000US06037542106,6037542106,2017,3191,2617,82.010002,2445,172
1400000US06037542200,6037542200,2017,962,753,78.269997,723,30
1400000US06037542402,6037542402,2017,2788,2340,83.93,2187,153
1400000US06037542601,6037542601,2017,533,415,77.860001,395,20
1400000US06037542700,6037542700,2017,1446,1209,83.610001,1157,52
1400000US06037542800,6037542800,2017,712,543,76.260002,500,43
1400000US06037542900,6037542900,2017,732,551,75.269997,495,56
1400000US06037543000,6037543000,2017,873,711,81.440002,663,48
1400000US06037543100,6037543100,2017,903,686,75.970001,644,42
1400000US06037543201,6037543201,2017,724,587,81.080002,550,37
1400000US06037543203,6037543203,2017,268,225,83.959999,213,12
1400000US06037543304,6037543304,2017,282,235,83.330002,181,54
1400000US06037543306,6037543306,2017,351,267,76.07,213,54
1400000US06037543321,6037543321,2017,677,288,42.540001,214,74
1400000US06037543322,6037543322,2017,919,759,82.589996,648,111
1400000US06037543400,6037543400,2017,316,270,85.440002,211,59
1400000US06037543501,6037543501,2017,1669,1277,76.510002,1038,239
1400000US06037543503,6037543503,2017,1042,896,85.989998,773,123
1400000US06037543601,6037543601,2017,926,659,71.169998,501,158
1400000US06037543607,6037543607,2017,419,280,66.830002,191,89
1400000US06037543701,6037543701,2017,3039,2287,75.260002,1738,549
1400000US06037543705,6037543705,2017,535,454,84.860001,389,65
1400000US06037543801,6037543801,2017,695,537,77.269997,418,119
1400000US06037543903,6037543903,2017,1420,1111,78.239998,868,243
1400000US06037544001,6037544001,2017,530,473,89.25,365,108
1400000US06037544002,6037544002,2017,931,768,82.489998,610,158
1400000US06037550101,6037550101,2017,306,222,72.550003,154,68
1400000US06037550201,6037550201,2017,272,209,76.839996,164,45
1400000US06037550202,6037550202,2017,366,271,74.040001,218,53
1400000US06037550301,6037550301,2017,485,327,67.419998,252,75
1400000US06037550501,6037550501,2017,679,503,74.080002,374,129
1400000US06037550602,6037550602,2017,688,365,53.049999,279,86
1400000US06037550700,6037550700,2017,2180,1419,65.089996,1059,360
1400000US06037550801,6037550801,2017,790,565,71.519997,449,116
1400000US06037550901,6037550901,2017,4137,2698,65.220001,1984,714
1400000US06037551001,6037551001,2017,806,445,55.209999,344,101
1400000US06037551002,6037551002,2017,1386,877,63.279999,638,239
1400000US06037551101,6037551101,2017,612,541,88.400002,450,91
1400000US06037551102,6037551102,2017,209,143,68.419998,116,27
1400000US06037551201,6037551201,2017,524,412,78.629997,330,82
1400000US06037551203,6037551203,2017,1189,949,79.809998,750,199
1400000US06037551204,6037551204,2017,586,445,75.940002,372,73
1400000US06037551300,6037551300,2017,3621,2405,66.419998,1733,672
1400000US06037551402,6037551402,2017,723,506,69.989998,389,117
1400000US06037551501,6037551501,2017,2254,1732,76.839996,1344,388
1400000US06037551700,6037551700,2017,426,347,81.459999,289,58
1400000US06037551801,6037551801,2017,1023,478,46.73,388,90
1400000US06037551802,6037551802,2017,771,557,72.239998,447,110
1400000US06037551900,6037551900,2017,419,370,88.309998,320,50
1400000US06037552001,6037552001,2017,389,334,85.860001,297,37
1400000US06037552100,6037552100,2017,3562,2893,81.220001,2513,380
1400000US06037552200,6037552200,2017,374,325,86.900002,307,18
1400000US06037552301,6037552301,2017,463,402,86.830002,352,50
1400000US06037552302,6037552302,2017,1304,1001,76.760002,880,121
1400000US06037552400,6037552400,2017,0,0,,0,0
1400000US06037552601,6037552601,2017,466,413,88.629997,384,29
1400000US06037552602,6037552602,2017,532,440,82.709999,382,58
1400000US06037552700,6037552700,2017,658,559,84.949997,509,50
1400000US06037552800,6037552800,2017,2199,1767,80.349998,1497,270
1400000US06037553000,6037553000,2017,527,420,79.699997,358,62
1400000US06037553100,6037553100,2017,2999,2283,76.129997,1698,585
1400000US06037553300,6037553300,2017,466,383,82.190002,300,83
1400000US06037553502,6037553502,2017,6113,5678,92.879997,4962,716
1400000US06037553504,6037553504,2017,677,642,94.830002,590,52
1400000US06037553601,6037553601,2017,590,574,97.290001,528,46
1400000US06037553701,6037553701,2017,585,564,96.410004,521,43
1400000US06037553702,6037553702,2017,1439,1369,95.139999,1229,140
1400000US06037553802,6037553802,2017,1261,1196,94.849998,1081,115
1400000US06037553901,6037553901,2017,1049,967,92.18,865,102
1400000US06037553902,6037553902,2017,1649,1565,94.910004,1399,166
1400000US06037554002,6037554002,2017,728,637,87.5,529,108
1400000US06037554106,6037554106,2017,562,494,87.900002,399,95
1400000US06037554201,6037554201,2017,777,647,83.269997,552,95
1400000US06037554405,6037554405,2017,721,537,74.480003,453,84
1400000US06037554511,6037554511,2017,2019,504,24.959999,343,161
1400000US06037554512,6037554512,2017,1568,342,21.809999,214,128
1400000US06037554514,6037554514,2017,644,445,69.099998,376,69
1400000US06037554515,6037554515,2017,790,234,29.620001,167,67
1400000US06037554516,6037554516,2017,3942,1402,35.57,1019,383
1400000US06037554517,6037554517,2017,742,121,16.309999,84,37
1400000US06037554518,6037554518,2017,671,109,16.24,75,34
1400000US06037554521,6037554521,2017,1981,1062,53.610001,822,240
1400000US06037554522,6037554522,2017,1196,571,47.740002,443,128
1400000US06037554700,6037554700,2017,337,316,93.769997,304,12
1400000US06037554801,6037554801,2017,692,520,75.139999,442,78
1400000US06037554802,6037554802,2017,1532,899,58.68,708,191
1400000US06037555001,6037555001,2017,426,373,87.559998,336,37
1400000US06037555002,6037555002,2017,372,312,83.870003,270,42
1400000US06037555105,6037555105,2017,2036,1511,74.209999,1260,251
1400000US06037555106,6037555106,2017,424,390,91.980003,348,42
1400000US06037555107,6037555107,2017,516,477,92.440002,436,41
1400000US06037555211,6037555211,2017,407,394,96.809998,367,27
1400000US06037555212,6037555212,2017,396,385,97.220001,350,35
1400000US06037555300,6037555300,2017,417,309,74.099998,215,94
1400000US06037570001,6037570001,2017,3787,1924,50.810001,1477,447
1400000US06037570002,6037570002,2017,726,607,83.610001,509,98
1400000US06037570100,6037570100,2017,536,494,92.160004,456,38
1400000US06037570202,6037570202,2017,910,841,92.419998,744,97
1400000US06037570203,6037570203,2017,655,604,92.209999,537,67
1400000US06037570402,6037570402,2017,1357,1247,91.889999,1093,154
1400000US06037570403,6037570403,2017,721,678,94.040001,596,82
1400000US06037570504,6037570504,2017,3973,3399,85.550003,2921,478
1400000US06037570601,6037570601,2017,615,579,94.150002,503,76
1400000US06037570602,6037570602,2017,893,807,90.370003,707,100
1400000US06037570701,6037570701,2017,586,470,80.199997,405,65
1400000US06037570800,6037570800,2017,1331,653,49.060001,469,184
1400000US06037570902,6037570902,2017,771,400,51.880001,279,121
1400000US06037571000,6037571000,2017,481,175,36.380001,141,34
1400000US06037571101,6037571101,2017,353,178,50.419998,147,31
1400000US06037571102,6037571102,2017,3220,1877,58.290001,1411,466
1400000US06037571202,6037571202,2017,1581,851,53.830002,645,206
1400000US06037571300,6037571300,2017,1253,860,68.639999,665,195
1400000US06037571400,6037571400,2017,387,207,53.490002,141,66
1400000US06037571502,6037571502,2017,607,547,90.120003,489,58
1400000US06037571701,6037571701,2017,1814,1675,92.339996,1469,206
1400000US06037571703,6037571703,2017,885,839,94.800003,757,82
1400000US06037571800,6037571800,2017,513,217,42.299999,166,51
1400000US06037571900,6037571900,2017,2512,1409,56.09,1093,316
1400000US06037572202,6037572202,2017,1597,1401,87.730003,1227,174
1400000US06037572500,6037572500,2017,579,514,88.769997,456,58
1400000US06037572600,6037572600,2017,846,780,92.199997,677,103
1400000US06037572700,6037572700,2017,734,682,92.919998,578,104
1400000US06037573101,6037573101,2017,959,796,83,732,64
1400000US06037573201,6037573201,2017,838,801,95.580002,708,93
1400000US06037573300,6037573300,2017,407,328,80.589996,258,70
1400000US06037573402,6037573402,2017,1498,1366,91.190002,1177,189
1400000US06037573601,6037573601,2017,443,224,50.560001,199,25
1400000US06037573700,6037573700,2017,793,216,27.24,148,68
1400000US06037573800,6037573800,2017,949,436,45.939999,324,112
1400000US06037573902,6037573902,2017,877,224,25.540001,167,57
1400000US06037574000,6037574000,2017,1027,308,29.99,238,70
1400000US06037574100,6037574100,2017,1445,586,40.549999,473,113
1400000US06037574201,6037574201,2017,461,245,53.150002,184,61
1400000US06037574202,6037574202,2017,141,128,90.779999,125,3
1400000US06037574300,6037574300,2017,1830,646,35.299999,499,147
1400000US06037574400,6037574400,2017,4054,1714,42.279999,1359,355
1400000US06037574500,6037574500,2017,734,345,47,260,85
1400000US06037574602,6037574602,2017,224,88,39.290001,67,21
1400000US06037574901,6037574901,2017,585,135,23.08,117,18
1400000US06037575002,6037575002,2017,356,285,80.059998,244,41
1400000US06037575101,6037575101,2017,888,783,88.18,712,71
1400000US06037575201,6037575201,2017,1053,896,85.089996,832,64
1400000US06037575300,6037575300,2017,5223,3680,70.459999,3226,454
1400000US06037575401,6037575401,2017,1612,1424,88.339996,1304,120
1400000US06037575402,6037575402,2017,44,25,56.82,24,1
1400000US06037575901,6037575901,2017,644,599,93.010002,570,29
1400000US06037576200,6037576200,2017,1070,941,87.940002,863,78
1400000US06037576301,6037576301,2017,1224,971,79.330002,884,87
1400000US06037576401,6037576401,2017,1091,988,90.559998,943,45
1400000US06037576501,6037576501,2017,1298,1227,94.529999,1131,96
1400000US06037576801,6037576801,2017,759,673,88.669998,599,74
1400000US06037576903,6037576903,2017,725,673,92.830002,622,51
1400000US06037577000,6037577000,2017,4751,3401,71.580002,2935,466
1400000US06037577100,6037577100,2017,896,450,50.220001,366,84
1400000US06037577501,6037577501,2017,356,47,13.2,44,3
1400000US06037577602,6037577602,2017,351,123,35.040001,101,22
1400000US06037577606,6037577606,2017,1599,320,20.01,273,47
1400000US06037577700,6037577700,2017,1089,894,82.089996,709,185
1400000US06037577800,6037577800,2017,603,418,69.32,291,127
1400000US06037577900,6037577900,2017,441,291,65.989998,263,28
1400000US06037578000,6037578000,2017,3318,2867,86.410004,2466,401
1400000US06037599000,6037599000,2017,585,429,73.330002,283,146
1400000US06037600201,6037600201,2017,954,900,94.339996,858,42
1400000US06037600302,6037600302,2017,1778,1517,85.32,1402,115
1400000US06037600303,6037600303,2017,828,746,90.099998,701,45
1400000US06037600501,6037600501,2017,298,255,85.57,240,15
1400000US06037600602,6037600602,2017,1728,1455,84.199997,1310,145
1400000US06037600703,6037600703,2017,622,566,91,480,86
1400000US06037600801,6037600801,2017,501,429,85.629997,393,36
1400000US06037600911,6037600911,2017,661,549,83.059998,475,74
1400000US06037601001,6037601001,2017,106,101,95.279999,95,6
1400000US06037601002,6037601002,2017,778,694,89.199997,616,78
1400000US06037601202,6037601202,2017,1131,945,83.550003,825,120
1400000US06037601211,6037601211,2017,1477,1122,75.959999,995,127
1400000US06037601212,6037601212,2017,393,368,93.639999,318,50
1400000US06037601301,6037601301,2017,693,524,75.610001,418,106
1400000US06037601303,6037601303,2017,1218,679,55.75,610,69
1400000US06037601401,6037601401,2017,723,661,91.419998,582,79
1400000US06037601402,6037601402,2017,645,599,92.870003,508,91
1400000US06037601501,6037601501,2017,191,143,74.870003,73,70
1400000US06037601502,6037601502,2017,1458,1399,95.949997,1246,153
1400000US06037601600,6037601600,2017,2151,2052,95.400002,1793,259
1400000US06037601700,6037601700,2017,2044,1887,92.32,1573,314
1400000US06037601802,6037601802,2017,607,579,95.389999,501,78
1400000US06037602003,6037602003,2017,420,394,93.809998,345,49
1400000US06037602104,6037602104,2017,599,528,88.150002,472,56
1400000US06037602106,6037602106,2017,1551,1320,85.110001,1145,175
1400000US06037602201,6037602201,2017,3406,2100,61.66,1711,389
1400000US06037602302,6037602302,2017,1926,854,44.34,576,278
1400000US06037602402,6037602402,2017,756,547,72.349998,459,88
1400000US06037602403,6037602403,2017,1552,1302,83.889999,1160,142
1400000US06037602404,6037602404,2017,546,470,86.080002,423,47
1400000US06037602505,6037602505,2017,896,755,84.260002,691,64
1400000US06037602506,6037602506,2017,724,623,86.050003,565,58
1400000US06037602511,6037602511,2017,1825,1599,87.620003,1460,139
1400000US06037602601,6037602601,2017,518,459,88.610001,405,54
1400000US06037602700,6037602700,2017,377,346,91.779999,291,55
1400000US06037602801,6037602801,2017,1211,1089,89.93,969,120
1400000US06037602802,6037602802,2017,1221,1163,95.25,1087,76
1400000US06037603006,6037603006,2017,388,340,87.629997,317,23
1400000US06037603008,6037603008,2017,770,629,81.690002,540,89
1400000US06037603200,6037603200,2017,1450,1287,88.760002,1087,200
1400000US06037603301,6037603301,2017,2049,1736,84.720001,1434,302
1400000US06037603400,6037603400,2017,784,592,75.510002,446,146
1400000US06037603600,6037603600,2017,211,175,82.940002,146,29
1400000US06037603702,6037603702,2017,534,332,62.169998,254,78
1400000US06037603705,6037603705,2017,125,120,96,120,0
1400000US06037603706,6037603706,2017,601,542,90.18,473,69
1400000US06037603801,6037603801,2017,1824,1541,84.480003,1289,252
1400000US06037603802,6037603802,2017,1695,1436,84.720001,1200,236
1400000US06037603901,6037603901,2017,3302,2635,79.800003,2151,484
1400000US06037603902,6037603902,2017,911,732,80.349998,592,140
1400000US06037604001,6037604001,2017,502,409,81.470001,324,85
1400000US06037604002,6037604002,2017,719,596,82.889999,489,107
1400000US06037604200,6037604200,2017,1500,1253,83.529999,1076,177
1400000US06037620001,6037620001,2017,773,104,13.45,68,36
1400000US06037620002,6037620002,2017,821,110,13.4,88,22
1400000US06037620101,6037620101,2017,1814,214,11.8,169,45
1400000US06037620303,6037620303,2017,633,8,1.26,7,1
1400000US06037620305,6037620305,2017,721,10,1.39,10,0
1400000US06037620400,6037620400,2017,1901,47,2.47,43,4
1400000US06037620501,6037620501,2017,611,47,7.6900001,29,18
1400000US06037620521,6037620521,2017,454,97,21.370001,74,23
1400000US06037620602,6037620602,2017,1744,360,20.639999,272,88
1400000US06037620701,6037620701,2017,463,76,16.41,61,15
1400000US06037620703,6037620703,2017,638,22,3.45,17,5
1400000US06037620802,6037620802,2017,2911,131,4.5,95,36
1400000US06037620904,6037620904,2017,422,7,1.66,7,0
1400000US06037621005,6037621005,2017,1365,37,2.71,37,0
1400000US06037621201,6037621201,2017,4527,618,13.65,466,152
1400000US06037621301,6037621301,2017,682,52,7.6199999,44,8
1400000US06037621400,6037621400,2017,473,57,12.05,38,19
1400000US06037650001,6037650001,2017,1160,380,32.759998,279,101
1400000US06037650004,6037650004,2017,325,176,54.150002,141,35
1400000US06037650101,6037650101,2017,585,183,31.280001,140,43
1400000US06037650200,6037650200,2017,2555,1044,40.860001,735,309
1400000US06037650300,6037650300,2017,586,283,48.290001,216,67
1400000US06037650401,6037650401,2017,1302,357,27.42,244,113
1400000US06037650502,6037650502,2017,1323,199,15.04,137,62
1400000US06037650603,6037650603,2017,2972,583,19.620001,432,151
1400000US06037650701,6037650701,2017,653,149,22.82,113,36
1400000US06037650702,6037650702,2017,622,55,8.8400002,44,11
1400000US06037650903,6037650903,2017,1973,571,28.940001,400,171
1400000US06037650904,6037650904,2017,655,396,60.459999,318,78
1400000US06037651001,6037651001,2017,716,315,43.990002,231,84
1400000US06037651002,6037651002,2017,825,314,38.060001,237,77
1400000US06037651101,6037651101,2017,941,119,12.65,72,47
1400000US06037651201,6037651201,2017,542,65,11.99,44,21
1400000US06037651221,6037651221,2017,686,127,18.51,83,44
1400000US06037651222,6037651222,2017,2764,429,15.52,287,142
1400000US06037651302,6037651302,2017,1346,149,11.07,103,46
1400000US06037651402,6037651402,2017,664,99,14.91,66,33
1400000US06037670002,6037670002,2017,1414,1217,86.07,1035,182
1400000US06037670003,6037670003,2017,934,606,64.879997,439,167
1400000US06037670101,6037670101,2017,546,484,88.639999,401,83
1400000US06037670202,6037670202,2017,443,11,2.48,9,2
1400000US06037670324,6037670324,2017,610,32,5.25,26,6
1400000US06037670326,6037670326,2017,478,16,3.3499999,15,1
1400000US06037670328,6037670328,2017,2918,58,1.99,51,7
1400000US06037670405,6037670405,2017,912,24,2.6300001,20,4
1400000US06037670413,6037670413,2017,442,13,2.9400001,13,0
1400000US06037670416,6037670416,2017,340,42,12.35,40,2
1400000US06037670417,6037670417,2017,2810,115,4.0900002,98,17
1400000US06037670418,6037670418,2017,919,5,.54000002,5,0
1400000US06037670500,6037670500,2017,64,10,15.63,10,0
1400000US06037670604,6037670604,2017,365,17,4.6599998,12,5
1400000US06037670701,6037670701,2017,2268,1565,69,1246,319
1400000US06037670702,6037670702,2017,891,54,6.0599999,46,8
1400000US06037700200,6037700200,2017,1798,844,46.939999,629,215
1400000US06037700400,6037700400,2017,277,151,54.509998,110,41
1400000US06037700501,6037700501,2017,377,52,13.79,39,13
1400000US06037700600,6037700600,2017,607,52,8.5699997,31,21
1400000US06037700700,6037700700,2017,643,50,7.7800002,41,9
1400000US06037700802,6037700802,2017,221,41,18.549999,34,7
1400000US06037700901,6037700901,2017,533,55,10.32,43,12
1400000US06037700902,6037700902,2017,696,56,8.0500002,47,9
1400000US06037701000,6037701000,2017,1438,107,7.4400001,90,17
1400000US06037701304,6037701304,2017,794,91,11.46,76,15
1400000US06037701501,6037701501,2017,1069,180,16.84,134,46
1400000US06037701601,6037701601,2017,808,36,4.46,28,8
1400000US06037701602,6037701602,2017,513,196,38.209999,151,45
1400000US06037701801,6037701801,2017,438,206,47.029999,169,37
1400000US06037701902,6037701902,2017,2740,738,26.93,604,134
1400000US06037702002,6037702002,2017,567,192,33.860001,150,42
1400000US06037702201,6037702201,2017,1593,664,41.68,540,124
1400000US06037702300,6037702300,2017,615,180,29.27,136,44
1400000US06037702400,6037702400,2017,552,179,32.43,132,47
1400000US06037702600,6037702600,2017,1350,282,20.889999,218,64
1400000US06037702700,6037702700,2017,4263,1296,30.4,1008,288
1400000US06037702801,6037702801,2017,568,309,54.400002,238,71
1400000US06037702803,6037702803,2017,641,458,71.449997,372,86
1400000US06037703002,6037703002,2017,532,395,74.25,334,61
1400000US06037703100,6037703100,2017,544,476,87.5,415,61
1400000US06037703200,6037703200,2017,314,260,82.800003,230,30
1400000US06037800101,6037800101,2017,3384,262,7.7399998,200,62
1400000US06037800103,6037800103,2017,286,23,8.04,18,5
1400000US06037800202,6037800202,2017,1498,120,8.0100002,95,25
1400000US06037800205,6037800205,2017,564,84,14.89,66,18
1400000US06037800206,6037800206,2017,608,25,4.1100001,17,8
1400000US06037800325,6037800325,2017,436,17,3.9000001,15,2
1400000US06037800334,6037800334,2017,2841,247,8.6899996,197,50
1400000US06037800335,6037800335,2017,35,35,100,35,0
1400000US06037800338,6037800338,2017,2003,123,6.1399999,103,20
1400000US06037800411,6037800411,2017,1173,133,11.34,107,26
1400000US06037800412,6037800412,2017,195,15,7.6900001,14,1
1400000US06037800504,6037800504,2017,289,15,5.1900001,13,2
1400000US06037900102,6037900102,2017,713,655,91.870003,618,37
1400000US06037900103,6037900103,2017,578,543,93.940002,513,30
1400000US06037900104,6037900104,2017,493,413,83.769997,379,34
1400000US06037900301,6037900301,2017,681,567,83.260002,529,38
1400000US06037900501,6037900501,2017,632,580,91.769997,548,32
1400000US06037900504,6037900504,2017,3258,2598,79.739998,2289,309
1400000US06037900505,6037900505,2017,816,719,88.110001,668,51
1400000US06037900508,6037900508,2017,2178,1758,80.720001,1549,209
1400000US06037900510,6037900510,2017,1482,1233,83.199997,1160,73
1400000US06037900602,6037900602,2017,1025,950,92.68,900,50
1400000US06037900606,6037900606,2017,3151,2560,81.239998,2400,160
1400000US06037900607,6037900607,2017,670,618,92.239998,582,36
1400000US06037900609,6037900609,2017,769,698,90.769997,631,67
1400000US06037900610,6037900610,2017,607,533,87.809998,499,34
1400000US06037900701,6037900701,2017,1064,952,89.470001,897,55
1400000US06037900703,6037900703,2017,1702,1466,86.129997,1287,179
1400000US06037900804,6037900804,2017,554,507,91.519997,462,45
1400000US06037900805,6037900805,2017,757,630,83.220001,559,71
1400000US06037900807,6037900807,2017,746,659,88.339996,597,62
1400000US06037900901,6037900901,2017,787,367,46.630001,318,49
1400000US06037901007,6037901007,2017,813,466,57.32,424,42
1400000US06037901009,6037901009,2017,1002,748,74.650002,631,117
1400000US06037901010,6037901010,2017,700,501,71.57,438,63
1400000US06037901011,6037901011,2017,666,467,70.120003,421,46
1400000US06037901012,6037901012,2017,725,508,70.07,438,70
1400000US06037901013,6037901013,2017,1178,685,58.150002,541,144
1400000US06037901014,6037901014,2017,2317,1455,62.799999,1211,244
1400000US06037901101,6037901101,2017,1033,498,48.209999,431,67
1400000US06037901209,6037901209,2017,366,217,59.290001,176,41
1400000US06037901214,6037901214,2017,994,481,48.389999,423,58
1400000US06037901215,6037901215,2017,3338,1287,38.560001,975,312
1400000US06037901217,6037901217,2017,105,28,26.67,23,5
1400000US06037901300,6037901300,2017,585,518,88.550003,486,32
1400000US06037910002,6037910002,2017,340,269,79.120003,231,38
1400000US06037910210,6037910210,2017,1097,464,42.299999,388,76
1400000US06037910212,6037910212,2017,890,171,19.209999,137,34
1400000US06037910214,6037910214,2017,4261,2818,66.129997,2363,455
1400000US06037910215,6037910215,2017,1600,1191,74.440002,1008,183
1400000US06037910217,6037910217,2017,666,361,54.200001,285,76
1400000US06037910218,6037910218,2017,631,364,57.689999,339,25
1400000US06037910301,6037910301,2017,832,463,55.650002,419,44
1400000US06037910302,6037910302,2017,1602,619,38.639999,518,101
1400000US06037910401,6037910401,2017,921,670,72.75,538,132
1400000US06037910404,6037910404,2017,679,595,87.629997,526,69
1400000US06037910405,6037910405,2017,1507,1280,84.940002,1138,142
1400000US06037910504,6037910504,2017,988,921,93.220001,837,84
1400000US06037910601,6037910601,2017,747,682,91.300003,629,53
1400000US06037910602,6037910602,2017,3736,3011,80.589996,2548,463
1400000US06037910605,6037910605,2017,1595,1340,84.010002,1215,125
1400000US06037910606,6037910606,2017,106,83,78.300003,77,6
1400000US06037910608,6037910608,2017,1008,886,87.900002,782,104
1400000US06037910706,6037910706,2017,805,624,77.519997,515,109
1400000US06037910712,6037910712,2017,693,587,84.699997,487,100
1400000US06037910714,6037910714,2017,1588,1362,85.769997,1141,221
1400000US06037910715,6037910715,2017,732,654,89.339996,567,87
1400000US06037910716,6037910716,2017,1354,1091,80.580002,935,156
1400000US06037910717,6037910717,2017,4629,3530,76.260002,2772,758
1400000US06037910718,6037910718,2017,1548,1249,80.68,1034,215
1400000US06037910720,6037910720,2017,888,789,88.849998,689,100
1400000US06037910804,6037910804,2017,2312,549,23.75,492,57
1400000US06037910807,6037910807,2017,1014,554,54.639999,432,122
1400000US06037910814,6037910814,2017,142,40,28.17,34,6
1400000US06037910815,6037910815,2017,3166,1158,36.580002,1000,158
1400000US06037911001,6037911001,2017,825,663,80.360001,603,60
1400000US06037911100,6037911100,2017,2392,2064,86.290001,1797,267
1400000US06037920013,6037920013,2017,734,80,10.9,64,16
1400000US06037920015,6037920015,2017,801,64,7.9899998,56,8
1400000US06037920017,6037920017,2017,965,210,21.76,149,61
1400000US06037920020,6037920020,2017,775,175,22.58,136,39
1400000US06037920029,6037920029,2017,2692,877,32.580002,663,214
1400000US06037920031,6037920031,2017,3184,1231,38.66,1029,202
1400000US06037920034,6037920034,2017,1096,587,53.560001,474,113
1400000US06037920035,6037920035,2017,500,409,81.800003,361,48
1400000US06037920041,6037920041,2017,610,176,28.85,143,33
1400000US06037920042,6037920042,2017,533,358,67.169998,307,51
1400000US06037920043,6037920043,2017,1520,514,33.82,402,112
1400000US06037920044,6037920044,2017,2329,298,12.8,219,79
1400000US06037920048,6037920048,2017,2203,1021,46.349998,871,150
1400000US06037920049,6037920049,2017,659,89,13.51,73,16
1400000US06037920102,6037920102,2017,803,280,34.869999,243,37
1400000US06037920109,6037920109,2017,684,110,16.08,84,26
1400000US06037920111,6037920111,2017,417,109,26.139999,75,34
1400000US06037920112,6037920112,2017,1245,95,7.6300001,73,22
1400000US06037920115,6037920115,2017,1568,158,10.08,110,48
1400000US06037920118,6037920118,2017,1996,502,25.15,383,119
1400000US06037920119,6037920119,2017,502,64,12.75,49,15
1400000US06037920120,6037920120,2017,604,50,8.2799997,38,12
1400000US06037920121,6037920121,2017,6555,1084,16.540001,852,232
1400000US06037920313,6037920313,2017,1120,738,65.889999,644,94
1400000US06037920314,6037920314,2017,521,181,34.740002,154,27
1400000US06037920322,6037920322,2017,442,190,42.990002,164,26
1400000US06037920326,6037920326,2017,930,146,15.7,107,39
1400000US06037920329,6037920329,2017,1761,985,55.93,863,122
1400000US06037920330,6037920330,2017,400,33,8.25,26,7
1400000US06037920334,6037920334,2017,1109,185,16.68,139,46
1400000US06037920338,6037920338,2017,783,52,6.6399999,40,12
1400000US06037920339,6037920339,2017,4007,334,8.3400002,228,106
1400000US06037920340,6037920340,2017,3278,967,29.5,835,132
1400000US06037920341,6037920341,2017,623,571,91.650002,512,59
1400000US06037920342,6037920342,2017,691,570,82.489998,508,62
1400000US06037930400,6037930400,2017,106,18,16.98,18,0
1400000US06037980004,6037980004,2017,878,855,97.379997,812,43
1400000US06037980013,6037980013,2017,779,329,42.23,222,107
1400000US06037980016,6037980016,2017,244,231,94.669998,223,8
1400000US06037101110,6037101110,2016,1402,971,69.260002,769,202
1400000US06037101220,6037101220,2016,286,258,90.209999,235,23
1400000US06037101300,6037101300,2016,342,194,56.73,155,39
1400000US06037102107,6037102107,2016,489,427,87.32,355,72
1400000US06037103101,6037103101,2016,878,637,72.550003,519,118
1400000US06037103102,6037103102,2016,767,577,75.230003,468,109
1400000US06037103202,6037103202,2016,177,151,85.309998,129,22
1400000US06037103402,6037103402,2016,408,228,55.880001,172,56
1400000US06037104103,6037104103,2016,746,626,83.910004,498,128
1400000US06037104105,6037104105,2016,982,871,88.699997,679,192
1400000US06037104108,6037104108,2016,1485,1349,90.839996,1185,164
1400000US06037104124,6037104124,2016,1188,973,81.900002,756,217
1400000US06037104204,6037104204,2016,603,574,95.190002,516,58
1400000US06037104310,6037104310,2016,2779,2719,97.839996,2473,246
1400000US06037104321,6037104321,2016,1325,1045,78.870003,974,71
1400000US06037104401,6037104401,2016,796,735,92.339996,653,82
1400000US06037104500,6037104500,2016,773,709,91.720001,628,81
1400000US06037104821,6037104821,2016,953,953,100,953,0
1400000US06037104822,6037104822,2016,1344,1191,88.620003,1021,170
1400000US06037106020,6037106020,2016,249,217,87.150002,187,30
1400000US06037106112,6037106112,2016,663,519,78.279999,439,80
1400000US06037106113,6037106113,2016,422,303,71.800003,236,67
1400000US06037106114,6037106114,2016,466,411,88.199997,331,80
1400000US06037106403,6037106403,2016,2508,2057,82.019997,1705,352
1400000US06037106405,6037106405,2016,2586,2205,85.269997,1847,358
1400000US06037106510,6037106510,2016,154,135,87.660004,135,0
1400000US06037106520,6037106520,2016,1682,1356,80.620003,1099,257
1400000US06037106603,6037106603,2016,502,165,32.869999,103,62
1400000US06037106604,6037106604,2016,490,436,88.980003,379,57
1400000US06037106641,6037106641,2016,1675,909,54.27,654,255
1400000US06037106642,6037106642,2016,496,129,26.01,88,41
1400000US06037106646,6037106646,2016,2525,1712,67.800003,1308,404
1400000US06037106648,6037106648,2016,328,296,90.239998,251,45
1400000US06037107020,6037107020,2016,705,633,89.790001,523,110
1400000US06037108104,6037108104,2016,771,117,15.18,75,42
1400000US06037108202,6037108202,2016,1077,99,9.1899996,65,34
1400000US06037109200,6037109200,2016,418,295,70.57,215,80
1400000US06037109300,6037109300,2016,583,410,70.330002,312,98
1400000US06037109500,6037109500,2016,2164,1942,89.739998,1624,318
1400000US06037109601,6037109601,2016,699,538,76.970001,413,125
1400000US06037109700,6037109700,2016,1590,1121,70.5,856,265
1400000US06037109800,6037109800,2016,816,461,56.5,298,163
1400000US06037111100,6037111100,2016,496,339,68.349998,252,87
1400000US06037111202,6037111202,2016,449,325,72.379997,242,83
1400000US06037111204,6037111204,2016,3067,1174,38.279999,809,365
1400000US06037111206,6037111206,2016,494,190,38.459999,141,49
1400000US06037111302,6037111302,2016,432,271,62.73,203,68
1400000US06037111303,6037111303,2016,2119,1358,64.089996,1020,338
1400000US06037111304,6037111304,2016,4385,2310,52.68,1518,792
1400000US06037111401,6037111401,2016,467,323,69.160004,242,81
1400000US06037113101,6037113101,2016,497,295,59.360001,225,70
1400000US06037113212,6037113212,2016,341,216,63.34,148,68
1400000US06037113232,6037113232,2016,428,343,80.139999,302,41
1400000US06037113303,6037113303,2016,655,373,56.950001,294,79
1400000US06037113322,6037113322,2016,437,133,30.43,100,33
1400000US06037113323,6037113323,2016,1465,877,59.860001,704,173
1400000US06037113324,6037113324,2016,2063,1360,65.919998,1079,281
1400000US06037113423,6037113423,2016,187,102,54.549999,85,17
1400000US06037113428,6037113428,2016,821,745,90.739998,658,87
1400000US06037115101,6037115101,2016,2692,1442,53.57,1078,364
1400000US06037115103,6037115103,2016,1049,744,70.919998,572,172
1400000US06037115202,6037115202,2016,556,337,60.610001,239,98
1400000US06037115301,6037115301,2016,561,223,39.75,153,70
1400000US06037115302,6037115302,2016,447,414,92.620003,378,36
1400000US06037115401,6037115401,2016,839,754,89.870003,671,83
1400000US06037115403,6037115403,2016,290,215,74.139999,185,30
1400000US06037117101,6037117101,2016,3270,2880,88.07,2577,303
1400000US06037117102,6037117102,2016,510,428,83.919998,356,72
1400000US06037117202,6037117202,2016,2738,2260,82.540001,1973,287
1400000US06037117302,6037117302,2016,635,567,89.290001,507,60
1400000US06037117303,6037117303,2016,259,69,26.639999,43,26
1400000US06037117407,6037117407,2016,573,548,95.639999,525,23
1400000US06037117510,6037117510,2016,486,441,90.739998,381,60
1400000US06037117520,6037117520,2016,702,658,93.730003,617,41
1400000US06037117530,6037117530,2016,867,791,91.230003,725,66
1400000US06037119003,6037119003,2016,713,653,91.580002,554,99
1400000US06037119004,6037119004,2016,532,426,80.080002,328,98
1400000US06037119201,6037119201,2016,1964,1693,86.199997,1394,299
1400000US06037119342,6037119342,2016,768,676,88.019997,598,78
1400000US06037119802,6037119802,2016,981,786,80.120003,595,191
1400000US06037119900,6037119900,2016,646,584,90.400002,519,65
1400000US06037120010,6037120010,2016,1202,1088,90.519997,1011,77
1400000US06037120020,6037120020,2016,841,758,90.129997,712,46
1400000US06037120030,6037120030,2016,1311,1135,86.580002,1042,93
1400000US06037120107,6037120107,2016,504,459,91.07,432,27
1400000US06037120108,6037120108,2016,1095,1035,94.519997,984,51
1400000US06037120300,6037120300,2016,430,386,89.769997,343,43
1400000US06037120400,6037120400,2016,555,478,86.129997,394,84
1400000US06037121010,6037121010,2016,4400,3893,88.480003,3268,625
1400000US06037121020,6037121020,2016,680,611,89.849998,516,95
1400000US06037121102,6037121102,2016,295,225,76.269997,186,39
1400000US06037121210,6037121210,2016,375,325,86.669998,271,54
1400000US06037121222,6037121222,2016,1193,1113,93.290001,971,142
1400000US06037121600,6037121600,2016,113,90,79.650002,74,16
1400000US06037121801,6037121801,2016,527,488,92.599998,455,33
1400000US06037121900,6037121900,2016,445,404,90.790001,358,46
1400000US06037122000,6037122000,2016,584,506,86.639999,375,131
1400000US06037122122,6037122122,2016,652,585,89.720001,530,55
1400000US06037122200,6037122200,2016,382,318,83.25,265,53
1400000US06037122420,6037122420,2016,669,594,88.790001,543,51
1400000US06037123010,6037123010,2016,1692,1524,90.07,1366,158
1400000US06037123301,6037123301,2016,619,560,90.470001,522,38
1400000US06037123303,6037123303,2016,760,703,92.5,633,70
1400000US06037123420,6037123420,2016,1637,1474,90.040001,1274,200
1400000US06037123510,6037123510,2016,809,727,89.860001,659,68
1400000US06037123601,6037123601,2016,1934,1437,74.300003,1247,190
1400000US06037123602,6037123602,2016,677,589,87,507,82
1400000US06037123700,6037123700,2016,673,525,78.010002,414,111
1400000US06037123901,6037123901,2016,2017,1852,91.82,1679,173
1400000US06037124102,6037124102,2016,751,676,90.010002,624,52
1400000US06037124201,6037124201,2016,873,796,91.18,664,132
1400000US06037124300,6037124300,2016,415,370,89.160004,317,53
1400000US06037124600,6037124600,2016,2061,747,36.240002,579,168
1400000US06037124700,6037124700,2016,634,199,31.389999,148,51
1400000US06037124902,6037124902,2016,375,296,78.93,235,61
1400000US06037125101,6037125101,2016,2552,1857,72.769997,1513,344
1400000US06037125102,6037125102,2016,672,149,22.17,108,41
1400000US06037125310,6037125310,2016,575,520,90.43,459,61
1400000US06037125322,6037125322,2016,444,378,85.139999,335,43
1400000US06037125600,6037125600,2016,459,376,81.919998,313,63
1400000US06037127210,6037127210,2016,2662,2424,91.059998,2173,251
1400000US06037127400,6037127400,2016,559,513,91.769997,449,64
1400000US06037127603,6037127603,2016,861,781,90.709999,697,84
1400000US06037127803,6037127803,2016,208,102,49.040001,91,11
1400000US06037127805,6037127805,2016,522,449,86.019997,404,45
1400000US06037127806,6037127806,2016,2579,1997,77.43,1622,375
1400000US06037127910,6037127910,2016,1293,820,63.419998,674,146
1400000US06037127920,6037127920,2016,736,673,91.440002,606,67
1400000US06037128102,6037128102,2016,951,826,86.860001,699,127
1400000US06037128302,6037128302,2016,814,750,92.139999,679,71
1400000US06037128602,6037128602,2016,455,254,55.82,192,62
1400000US06037128802,6037128802,2016,2116,1416,66.919998,1165,251
1400000US06037128910,6037128910,2016,229,73,31.879999,59,14
1400000US06037131022,6037131022,2016,533,470,88.18,413,57
1400000US06037131023,6037131023,2016,396,356,89.900002,300,56
1400000US06037131100,6037131100,2016,412,317,76.940002,273,44
1400000US06037131200,6037131200,2016,583,368,63.119999,294,74
1400000US06037131300,6037131300,2016,508,441,86.809998,388,53
1400000US06037131600,6037131600,2016,3463,2288,66.07,1807,481
1400000US06037131701,6037131701,2016,61,40,65.57,28,12
1400000US06037131801,6037131801,2016,402,353,87.809998,310,43
1400000US06037131900,6037131900,2016,444,372,83.779999,298,74
1400000US06037132001,6037132001,2016,393,291,74.050003,219,72
1400000US06037132002,6037132002,2016,6133,4927,80.339996,4101,826
1400000US06037132301,6037132301,2016,396,334,84.339996,283,51
1400000US06037132501,6037132501,2016,21,16,76.190002,14,2
1400000US06037132700,6037132700,2016,2086,1699,81.449997,1430,269
1400000US06037133000,6037133000,2016,493,418,84.790001,358,60
1400000US06037133101,6037133101,2016,400,315,78.75,261,54
1400000US06037133102,6037133102,2016,2080,1104,53.080002,789,315
1400000US06037134001,6037134001,2016,823,769,93.440002,708,61
1400000US06037134002,6037134002,2016,399,220,55.139999,177,43
1400000US06037134101,6037134101,2016,493,423,85.800003,369,54
1400000US06037134103,6037134103,2016,551,483,87.660004,446,37
1400000US06037134104,6037134104,2016,386,337,87.309998,293,44
1400000US06037134302,6037134302,2016,408,296,72.550003,230,66
1400000US06037134303,6037134303,2016,695,635,91.370003,575,60
1400000US06037134304,6037134304,2016,1132,923,81.540001,762,161
1400000US06037134421,6037134421,2016,622,113,18.17,90,23
1400000US06037134422,6037134422,2016,242,165,68.18,127,38
1400000US06037134423,6037134423,2016,387,128,33.07,89,39
1400000US06037134520,6037134520,2016,1401,1161,82.870003,1004,157
1400000US06037134522,6037134522,2016,685,610,89.050003,567,43
1400000US06037134720,6037134720,2016,1541,1332,86.440002,1125,207
1400000US06037134801,6037134801,2016,466,411,88.199997,343,68
1400000US06037135102,6037135102,2016,418,193,46.169998,154,39
1400000US06037135202,6037135202,2016,807,96,11.9,59,37
1400000US06037135204,6037135204,2016,799,175,21.9,116,59
1400000US06037137000,6037137000,2016,3750,772,20.59,583,189
1400000US06037137104,6037137104,2016,951,663,69.720001,535,128
1400000US06037137203,6037137203,2016,829,485,58.5,379,106
1400000US06037137301,6037137301,2016,501,157,31.34,123,34
1400000US06037137302,6037137302,2016,1979,603,30.469999,422,181
1400000US06037137401,6037137401,2016,703,86,12.23,61,25
1400000US06037137402,6037137402,2016,423,76,17.969999,51,25
1400000US06037137501,6037137501,2016,3078,1706,55.43,1402,304
1400000US06037139001,6037139001,2016,380,143,37.630001,116,27
1400000US06037139200,6037139200,2016,393,257,65.389999,207,50
1400000US06037139301,6037139301,2016,777,561,72.199997,479,82
1400000US06037139402,6037139402,2016,3277,1227,37.439999,957,270
1400000US06037139502,6037139502,2016,554,295,53.25,217,78
1400000US06037139600,6037139600,2016,553,107,19.35,87,20
1400000US06037139701,6037139701,2016,551,22,3.99,20,2
1400000US06037141101,6037141101,2016,725,175,24.139999,140,35
1400000US06037141304,6037141304,2016,848,206,24.290001,163,43
1400000US06037141400,6037141400,2016,544,88,16.18,65,23
1400000US06037143200,6037143200,2016,836,472,56.459999,383,89
1400000US06037143302,6037143302,2016,1609,841,52.27,691,150
1400000US06037143700,6037143700,2016,227,41,18.059999,34,7
1400000US06037143801,6037143801,2016,928,51,5.5,40,11
1400000US06037181000,6037181000,2016,1156,883,76.379997,730,153
1400000US06037181400,6037181400,2016,808,432,53.470001,324,108
1400000US06037181500,6037181500,2016,963,594,61.68,469,125
1400000US06037181600,6037181600,2016,2326,1337,57.48,987,350
1400000US06037183101,6037183101,2016,1168,1031,88.269997,878,153
1400000US06037183104,6037183104,2016,245,195,79.589996,170,25
1400000US06037183220,6037183220,2016,274,242,88.32,201,41
1400000US06037183221,6037183221,2016,102,101,99.019997,101,0
1400000US06037183401,6037183401,2016,461,363,78.739998,287,76
1400000US06037183402,6037183402,2016,331,283,85.5,226,57
1400000US06037183510,6037183510,2016,1398,1197,85.620003,1047,150
1400000US06037183520,6037183520,2016,440,412,93.639999,372,40
1400000US06037183702,6037183702,2016,304,264,86.839996,223,41
1400000US06037183810,6037183810,2016,633,590,93.209999,547,43
1400000US06037185101,6037185101,2016,529,416,78.639999,338,78
1400000US06037185102,6037185102,2016,533,396,74.300003,344,52
1400000US06037185204,6037185204,2016,416,58,13.94,40,18
1400000US06037185310,6037185310,2016,1074,993,92.459999,891,102
1400000US06037186100,6037186100,2016,471,291,61.779999,210,81
1400000US06037186302,6037186302,2016,193,179,92.75,152,27
1400000US06037186401,6037186401,2016,1939,1722,88.809998,1523,199
1400000US06037186404,6037186404,2016,390,364,93.330002,323,41
1400000US06037187101,6037187101,2016,302,244,80.790001,203,41
1400000US06037187102,6037187102,2016,1497,1018,68,793,225
1400000US06037187300,6037187300,2016,405,350,86.419998,264,86
1400000US06037188201,6037188201,2016,458,52,11.35,37,15
1400000US06037188300,6037188300,2016,303,210,69.309998,176,34
1400000US06037189201,6037189201,2016,464,377,81.25,307,70
1400000US06037189501,6037189501,2016,334,240,71.860001,218,22
1400000US06037189905,6037189905,2016,436,249,57.110001,191,58
1400000US06037190102,6037190102,2016,1439,1196,83.110001,1013,183
1400000US06037190510,6037190510,2016,527,487,92.410004,436,51
1400000US06037190701,6037190701,2016,154,142,92.209999,122,20
1400000US06037190901,6037190901,2016,1202,1050,87.349998,929,121
1400000US06037190902,6037190902,2016,1048,956,91.220001,850,106
1400000US06037191120,6037191120,2016,461,436,94.580002,400,36
1400000US06037191204,6037191204,2016,612,564,92.160004,518,46
1400000US06037191301,6037191301,2016,170,156,91.760002,141,15
1400000US06037191410,6037191410,2016,437,393,89.93,352,41
1400000US06037191720,6037191720,2016,910,889,97.690002,844,45
1400000US06037191810,6037191810,2016,505,471,93.269997,419,52
1400000US06037191901,6037191901,2016,811,678,83.599998,593,85
1400000US06037192001,6037192001,2016,336,193,57.439999,137,56
1400000US06037192002,6037192002,2016,2019,1551,76.82,1270,281
1400000US06037192410,6037192410,2016,244,203,83.199997,160,43
1400000US06037192520,6037192520,2016,457,410,89.720001,370,40
1400000US06037192620,6037192620,2016,731,673,92.07,613,60
1400000US06037192700,6037192700,2016,532,491,92.290001,438,53
1400000US06037194300,6037194300,2016,514,40,7.7800002,31,9
1400000US06037195201,6037195201,2016,2757,1771,64.239998,1412,359
1400000US06037195300,6037195300,2016,1931,1247,64.580002,1027,220
1400000US06037195400,6037195400,2016,356,208,58.43,167,41
1400000US06037195500,6037195500,2016,292,254,86.989998,215,39
1400000US06037195710,6037195710,2016,1019,928,91.07,847,81
1400000US06037197200,6037197200,2016,306,242,79.080002,190,52
1400000US06037197300,6037197300,2016,236,166,70.339996,128,38
1400000US06037197410,6037197410,2016,137,102,74.449997,76,26
1400000US06037197420,6037197420,2016,859,749,87.190002,640,109
1400000US06037199001,6037199001,2016,196,123,62.759998,109,14
1400000US06037199002,6037199002,2016,393,367,93.379997,338,29
1400000US06037199120,6037199120,2016,97,89,91.75,88,1
1400000US06037199201,6037199201,2016,343,302,88.050003,276,26
1400000US06037199202,6037199202,2016,1504,1346,89.489998,1181,165
1400000US06037199300,6037199300,2016,705,629,89.220001,562,67
1400000US06037199400,6037199400,2016,237,221,93.25,200,21
1400000US06037199700,6037199700,2016,1693,1560,92.139999,1397,163
1400000US06037199801,6037199801,2016,499,470,94.190002,418,52
1400000US06037199802,6037199802,2016,717,649,90.519997,577,72
1400000US06037201110,6037201110,2016,536,184,34.330002,120,64
1400000US06037201120,6037201120,2016,263,204,77.57,171,33
1400000US06037201200,6037201200,2016,413,365,88.379997,315,50
1400000US06037201301,6037201301,2016,397,377,94.959999,340,37
1400000US06037201401,6037201401,2016,1757,1541,87.709999,1329,212
1400000US06037201402,6037201402,2016,1930,1687,87.410004,1442,245
1400000US06037201501,6037201501,2016,325,293,90.150002,252,41
1400000US06037201602,6037201602,2016,396,347,87.629997,287,60
1400000US06037201700,6037201700,2016,584,60,10.27,49,11
1400000US06037203100,6037203100,2016,471,449,95.330002,423,26
1400000US06037203200,6037203200,2016,818,783,95.720001,718,65
1400000US06037203300,6037203300,2016,2049,1689,82.43,1394,295
1400000US06037203500,6037203500,2016,248,228,91.940002,207,21
1400000US06037203601,6037203601,2016,925,872,94.269997,817,55
1400000US06037203800,6037203800,2016,697,639,91.68,585,54
1400000US06037204110,6037204110,2016,117,111,94.870003,92,19
1400000US06037204300,6037204300,2016,2745,2410,87.800003,2180,230
1400000US06037204410,6037204410,2016,384,348,90.629997,321,27
1400000US06037204420,6037204420,2016,915,818,89.400002,752,66
1400000US06037204700,6037204700,2016,2342,2202,94.019997,1984,218
1400000US06037204810,6037204810,2016,1549,1427,92.120003,1263,164
1400000US06037204820,6037204820,2016,614,574,93.489998,528,46
1400000US06037204910,6037204910,2016,1556,1445,92.870003,1278,167
1400000US06037205110,6037205110,2016,1064,1019,95.769997,944,75
1400000US06037205120,6037205120,2016,129,124,96.120003,117,7
1400000US06037206010,6037206010,2016,348,280,80.459999,231,49
1400000US06037206050,6037206050,2016,97,96,98.970001,87,9
1400000US06037206051,6037206051,2016,510,479,93.919998,437,42
1400000US06037206054,6037206054,2016,1334,1188,89.059998,1080,108
1400000US06037207101,6037207101,2016,1488,1090,73.25,905,185
1400000US06037207103,6037207103,2016,635,514,80.940002,424,90
1400000US06037207400,6037207400,2016,402,396,98.510002,390,6
1400000US06037208001,6037208001,2016,3177,2790,87.82,2489,301
1400000US06037208002,6037208002,2016,646,573,88.699997,505,68
1400000US06037208302,6037208302,2016,1684,1461,86.760002,1338,123
1400000US06037208401,6037208401,2016,1123,1077,95.900002,1031,46
1400000US06037208501,6037208501,2016,689,426,61.830002,354,72
1400000US06037208610,6037208610,2016,504,475,94.25,458,17
1400000US06037208710,6037208710,2016,101,97,96.040001,90,7
1400000US06037208801,6037208801,2016,529,464,87.709999,455,9
1400000US06037208802,6037208802,2016,436,380,87.160004,368,12
1400000US06037208902,6037208902,2016,1352,1325,98,1311,14
1400000US06037209103,6037209103,2016,883,804,91.050003,772,32
1400000US06037209104,6037209104,2016,338,338,100,335,3
1400000US06037209106,6037209106,2016,1076,1008,93.68,965,43
1400000US06037209202,6037209202,2016,1686,1374,81.489998,1278,96
1400000US06037209520,6037209520,2016,90,83,92.220001,82,1
1400000US06037209820,6037209820,2016,111,100,90.089996,87,13
1400000US06037210010,6037210010,2016,852,825,96.830002,787,38
1400000US06037211000,6037211000,2016,1842,1375,74.650002,1103,272
1400000US06037211121,6037211121,2016,1145,1047,91.440002,958,89
1400000US06037211122,6037211122,2016,2803,2565,91.510002,2350,215
1400000US06037211123,6037211123,2016,926,878,94.82,800,78
1400000US06037211124,6037211124,2016,558,536,96.059998,485,51
1400000US06037211202,6037211202,2016,742,679,91.510002,632,47
1400000US06037211410,6037211410,2016,707,560,79.209999,444,116
1400000US06037211420,6037211420,2016,523,419,80.110001,343,76
1400000US06037212202,6037212202,2016,781,730,93.470001,699,31
1400000US06037212204,6037212204,2016,668,609,91.169998,506,103
1400000US06037212303,6037212303,2016,204,191,93.629997,175,16
1400000US06037212304,6037212304,2016,3857,3410,88.410004,3090,320
1400000US06037212610,6037212610,2016,1220,971,79.589996,815,156
1400000US06037212800,6037212800,2016,1708,1459,85.419998,1306,153
1400000US06037213201,6037213201,2016,647,583,90.110001,536,47
1400000US06037213202,6037213202,2016,741,663,89.470001,616,47
1400000US06037213310,6037213310,2016,204,199,97.550003,185,14
1400000US06037213320,6037213320,2016,1153,1094,94.879997,1035,59
1400000US06037213402,6037213402,2016,729,716,98.220001,691,25
1400000US06037214100,6037214100,2016,681,137,20.120001,109,28
1400000US06037214501,6037214501,2016,737,155,21.030001,113,42
1400000US06037216201,6037216201,2016,191,163,85.339996,140,23
1400000US06037216301,6037216301,2016,346,227,65.610001,184,43
1400000US06037216700,6037216700,2016,2011,1234,61.360001,958,276
1400000US06037217101,6037217101,2016,392,369,94.129997,329,40
1400000US06037218110,6037218110,2016,2024,1516,74.900002,1363,153
1400000US06037218210,6037218210,2016,554,504,90.970001,466,38
1400000US06037218300,6037218300,2016,306,90,29.41,86,4
1400000US06037218800,6037218800,2016,632,592,93.669998,545,47
1400000US06037218900,6037218900,2016,648,560,86.419998,475,85
1400000US06037219010,6037219010,2016,617,538,87.199997,511,27
1400000US06037219300,6037219300,2016,562,517,91.989998,469,48
1400000US06037219700,6037219700,2016,1139,891,78.230003,800,91
1400000US06037219800,6037219800,2016,614,557,90.720001,499,58
1400000US06037219902,6037219902,2016,889,801,90.099998,721,80
1400000US06037220000,6037220000,2016,405,376,92.839996,346,30
1400000US06037220100,6037220100,2016,619,493,79.639999,437,56
1400000US06037221120,6037221120,2016,1106,1065,96.290001,986,79
1400000US06037221304,6037221304,2016,862,740,85.849998,691,49
1400000US06037221401,6037221401,2016,1115,1029,92.290001,970,59
1400000US06037221602,6037221602,2016,2308,2144,92.889999,2019,125
1400000US06037221810,6037221810,2016,645,606,93.949997,543,63
1400000US06037221900,6037221900,2016,412,383,92.959999,354,29
1400000US06037222002,6037222002,2016,701,640,91.300003,576,64
1400000US06037222500,6037222500,2016,1947,1688,86.699997,1511,177
1400000US06037222600,6037222600,2016,623,556,89.25,528,28
1400000US06037224010,6037224010,2016,32,32,100,32,0
1400000US06037224020,6037224020,2016,1816,1689,93.010002,1536,153
1400000US06037224320,6037224320,2016,444,422,95.050003,390,32
1400000US06037224410,6037224410,2016,1989,1770,88.989998,1576,194
1400000US06037224420,6037224420,2016,936,834,89.099998,792,42
1400000US06037224600,6037224600,2016,1341,1220,90.980003,1141,79
1400000US06037224702,6037224702,2016,1047,932,89.019997,771,161
1400000US06037226001,6037226001,2016,3022,2851,94.339996,2662,189
1400000US06037226002,6037226002,2016,924,837,90.580002,768,69
1400000US06037226702,6037226702,2016,1424,1362,95.650002,1275,87
1400000US06037227020,6037227020,2016,1481,1418,95.75,1327,91
1400000US06037228100,6037228100,2016,1769,1697,95.93,1631,66
1400000US06037228210,6037228210,2016,1849,1621,87.669998,1523,98
1400000US06037228310,6037228310,2016,1332,1226,92.040001,1162,64
1400000US06037228320,6037228320,2016,632,589,93.199997,541,48
1400000US06037228410,6037228410,2016,551,512,92.919998,478,34
1400000US06037228420,6037228420,2016,1205,1170,97.099998,1060,110
1400000US06037228500,6037228500,2016,615,586,95.279999,526,60
1400000US06037228600,6037228600,2016,2089,1985,95.019997,1894,91
1400000US06037228710,6037228710,2016,1201,1102,91.760002,1050,52
1400000US06037228720,6037228720,2016,849,815,96,758,57
1400000US06037228800,6037228800,2016,294,277,94.220001,273,4
1400000US06037229200,6037229200,2016,816,770,94.360001,740,30
1400000US06037229300,6037229300,2016,419,409,97.610001,386,23
1400000US06037229410,6037229410,2016,2996,2740,91.459999,2608,132
1400000US06037229420,6037229420,2016,1872,1740,92.949997,1645,95
1400000US06037231100,6037231100,2016,1722,1646,95.589996,1526,120
1400000US06037231220,6037231220,2016,1103,930,84.32,763,167
1400000US06037231302,6037231302,2016,463,420,90.709999,384,36
1400000US06037231400,6037231400,2016,92,92,100,91,1
1400000US06037231500,6037231500,2016,391,367,93.860001,321,46
1400000US06037231603,6037231603,2016,1469,1319,89.790001,1213,106
1400000US06037231710,6037231710,2016,556,535,96.220001,506,29
1400000US06037231720,6037231720,2016,228,220,96.489998,194,26
1400000US06037231800,6037231800,2016,726,691,95.18,663,28
1400000US06037232110,6037232110,2016,1627,1536,94.410004,1457,79
1400000US06037232200,6037232200,2016,1356,1265,93.290001,1143,122
1400000US06037232300,6037232300,2016,188,184,97.870003,171,13
1400000US06037232401,6037232401,2016,892,792,88.790001,746,46
1400000US06037232500,6037232500,2016,544,489,89.889999,449,40
1400000US06037234001,6037234001,2016,741,674,90.959999,628,46
1400000US06037234002,6037234002,2016,427,422,98.830002,422,0
1400000US06037234301,6037234301,2016,774,656,84.75,621,35
1400000US06037234501,6037234501,2016,1274,1119,87.830002,1037,82
1400000US06037234502,6037234502,2016,686,604,88.050003,543,61
1400000US06037234600,6037234600,2016,2589,2164,83.580002,1904,260
1400000US06037234700,6037234700,2016,338,309,91.419998,279,30
1400000US06037234901,6037234901,2016,581,549,94.489998,521,28
1400000US06037235201,6037235201,2016,1200,1092,91,1013,79
1400000US06037236203,6037236203,2016,742,693,93.400002,609,84
1400000US06037236204,6037236204,2016,678,594,87.610001,564,30
1400000US06037236400,6037236400,2016,218,194,88.989998,169,25
1400000US06037237101,6037237101,2016,3495,3119,89.239998,2951,168
1400000US06037237102,6037237102,2016,555,503,90.629997,469,34
1400000US06037237300,6037237300,2016,621,386,62.16,356,30
1400000US06037237500,6037237500,2016,639,552,86.379997,521,31
1400000US06037237600,6037237600,2016,814,742,91.150002,708,34
1400000US06037237800,6037237800,2016,533,471,88.370003,424,47
1400000US06037237900,6037237900,2016,543,457,84.160004,421,36
1400000US06037238000,6037238000,2016,664,605,91.110001,578,27
1400000US06037238200,6037238200,2016,439,393,89.519997,343,50
1400000US06037238320,6037238320,2016,1096,983,89.690002,850,133
1400000US06037238400,6037238400,2016,418,390,93.300003,371,19
1400000US06037239201,6037239201,2016,1036,963,92.949997,919,44
1400000US06037239320,6037239320,2016,1137,1066,93.760002,1005,61
1400000US06037239330,6037239330,2016,831,782,94.099998,741,41
1400000US06037239502,6037239502,2016,3519,3292,93.550003,3090,202
1400000US06037239601,6037239601,2016,1032,980,94.959999,927,53
1400000US06037239802,6037239802,2016,1013,952,93.980003,898,54
1400000US06037240010,6037240010,2016,1223,1157,94.599998,1106,51
1400000US06037240020,6037240020,2016,110,101,91.82,94,7
1400000US06037240200,6037240200,2016,865,811,93.760002,764,47
1400000US06037240301,6037240301,2016,819,795,97.07,763,32
1400000US06037240302,6037240302,2016,189,180,95.239998,171,9
1400000US06037240401,6037240401,2016,1614,1475,91.389999,1412,63
1400000US06037240500,6037240500,2016,1422,1352,95.080002,1229,123
1400000US06037240600,6037240600,2016,1068,1027,96.160004,965,62
1400000US06037240700,6037240700,2016,598,554,92.639999,516,38
1400000US06037240902,6037240902,2016,2442,2334,95.580002,2208,126
1400000US06037241001,6037241001,2016,931,888,95.379997,796,92
1400000US06037241110,6037241110,2016,882,854,96.830002,816,38
1400000US06037241120,6037241120,2016,557,513,92.099998,485,28
1400000US06037241202,6037241202,2016,568,542,95.419998,506,36
1400000US06037241400,6037241400,2016,626,601,96.010002,559,42
1400000US06037242000,6037242000,2016,462,443,95.889999,432,11
1400000US06037242100,6037242100,2016,1035,946,91.400002,909,37
1400000US06037242201,6037242201,2016,861,819,95.120003,772,47
1400000US06037242202,6037242202,2016,943,910,96.5,855,55
1400000US06037242300,6037242300,2016,796,750,94.220001,701,49
1400000US06037242600,6037242600,2016,547,537,98.169998,524,13
1400000US06037242700,6037242700,2016,1490,1334,89.529999,1280,54
1400000US06037243001,6037243001,2016,491,488,99.389999,474,14
1400000US06037243002,6037243002,2016,457,434,94.970001,408,26
1400000US06037243100,6037243100,2016,607,559,92.089996,541,18
1400000US06037262200,6037262200,2016,907,154,16.98,105,49
1400000US06037262303,6037262303,2016,526,30,5.6999998,28,2
1400000US06037262604,6037262604,2016,533,35,6.5700002,35,0
1400000US06037262704,6037262704,2016,2887,856,29.65,667,189
1400000US06037262706,6037262706,2016,525,30,5.71,27,3
1400000US06037262802,6037262802,2016,2488,494,19.860001,404,90
1400000US06037264305,6037264305,2016,895,719,80.339996,607,112
1400000US06037265100,6037265100,2016,698,46,6.5900002,31,15
1400000US06037265601,6037265601,2016,1059,341,32.200001,286,55
1400000US06037267202,6037267202,2016,848,61,7.1900001,46,15
1400000US06037267300,6037267300,2016,328,233,71.040001,193,40
1400000US06037267404,6037267404,2016,1621,1152,71.07,891,261
1400000US06037267406,6037267406,2016,212,148,69.809998,130,18
1400000US06037267600,6037267600,2016,1163,249,21.41,183,66
1400000US06037269000,6037269000,2016,577,168,29.120001,146,22
1400000US06037269100,6037269100,2016,345,91,26.379999,75,16
1400000US06037269300,6037269300,2016,494,34,6.8800001,29,5
1400000US06037269700,6037269700,2016,3313,2205,66.559998,1823,382
1400000US06037269907,6037269907,2016,366,273,74.589996,236,37
1400000US06037271200,6037271200,2016,355,121,34.080002,83,38
1400000US06037271300,6037271300,2016,874,675,77.230003,596,79
1400000US06037271400,6037271400,2016,320,136,42.5,115,21
1400000US06037271500,6037271500,2016,578,77,13.32,57,20
1400000US06037271702,6037271702,2016,593,122,20.57,96,26
1400000US06037271703,6037271703,2016,1496,844,56.419998,649,195
1400000US06037271801,6037271801,2016,337,249,73.889999,219,30
1400000US06037272100,6037272100,2016,911,658,72.230003,578,80
1400000US06037272302,6037272302,2016,35,21,60,14,7
1400000US06037273200,6037273200,2016,1178,628,53.310001,506,122
1400000US06037273403,6037273403,2016,345,291,84.349998,250,41
1400000US06037273800,6037273800,2016,2530,1467,57.98,1245,222
1400000US06037274202,6037274202,2016,377,300,79.580002,257,43
1400000US06037275200,6037275200,2016,596,580,97.32,530,50
1400000US06037275311,6037275311,2016,1513,736,48.650002,615,121
1400000US06037275400,6037275400,2016,263,151,57.41,121,30
1400000US06037275500,6037275500,2016,687,570,82.970001,509,61
1400000US06037275603,6037275603,2016,255,114,44.709999,91,23
1400000US06037275604,6037275604,2016,522,99,18.969999,78,21
1400000US06037275605,6037275605,2016,437,338,77.349998,275,63
1400000US06037276000,6037276000,2016,351,224,63.82,176,48
1400000US06037276400,6037276400,2016,361,102,28.25,77,25
1400000US06037276605,6037276605,2016,496,262,52.82,187,75
1400000US06037276607,6037276607,2016,371,248,66.849998,196,52
1400000US06037276608,6037276608,2016,1269,688,54.220001,566,122
1400000US06037277000,6037277000,2016,1571,757,48.189999,584,173
1400000US06037277100,6037277100,2016,409,59,14.43,40,19
1400000US06037291120,6037291120,2016,788,728,92.389999,631,97
1400000US06037291210,6037291210,2016,551,507,92.010002,447,60
1400000US06037291220,6037291220,2016,354,338,95.480003,255,83
1400000US06037291300,6037291300,2016,985,802,81.419998,694,108
1400000US06037293204,6037293204,2016,521,427,81.959999,355,72
1400000US06037293302,6037293302,2016,3317,2435,73.410004,2050,385
1400000US06037293304,6037293304,2016,625,573,91.68,495,78
1400000US06037294110,6037294110,2016,3095,2679,86.559998,2288,391
1400000US06037294200,6037294200,2016,1423,1288,90.510002,1134,154
1400000US06037294302,6037294302,2016,447,313,70.019997,225,88
1400000US06037294410,6037294410,2016,349,322,92.260002,305,17
1400000US06037294510,6037294510,2016,858,780,90.910004,694,86
1400000US06037294520,6037294520,2016,503,451,89.660004,404,47
1400000US06037294610,6037294610,2016,1184,1077,90.959999,934,143
1400000US06037294620,6037294620,2016,803,733,91.279999,632,101
1400000US06037294830,6037294830,2016,680,605,88.970001,564,41
1400000US06037294900,6037294900,2016,654,585,89.449997,539,46
1400000US06037295103,6037295103,2016,764,409,53.529999,316,93
1400000US06037296220,6037296220,2016,948,570,60.130001,451,119
1400000US06037296300,6037296300,2016,732,418,57.099998,315,103
1400000US06037296401,6037296401,2016,580,338,58.279999,286,52
1400000US06037296500,6037296500,2016,1011,932,92.190002,832,100
1400000US06037296600,6037296600,2016,408,377,92.400002,347,30
1400000US06037296901,6037296901,2016,3916,2485,63.459999,2039,446
1400000US06037297110,6037297110,2016,220,179,81.360001,156,23
1400000US06037297120,6037297120,2016,525,481,91.620003,447,34
1400000US06037297202,6037297202,2016,551,423,76.769997,339,84
1400000US06037297400,6037297400,2016,484,198,40.91,148,50
1400000US06037297501,6037297501,2016,376,100,26.6,61,39
1400000US06037297601,6037297601,2016,54,39,72.220001,37,2
1400000US06037297602,6037297602,2016,337,216,64.089996,164,52
1400000US06037300200,6037300200,2016,2593,390,15.04,283,107
1400000US06037300301,6037300301,2016,2033,733,36.060001,551,182
1400000US06037300400,6037300400,2016,506,119,23.52,80,39
1400000US06037300501,6037300501,2016,3245,643,19.82,495,148
1400000US06037300602,6037300602,2016,683,137,20.059999,102,35
1400000US06037300800,6037300800,2016,814,200,24.57,134,66
1400000US06037300902,6037300902,2016,558,178,31.9,130,48
1400000US06037301000,6037301000,2016,1228,729,59.360001,604,125
1400000US06037301206,6037301206,2016,3875,2191,56.540001,1689,502
1400000US06037301400,6037301400,2016,768,405,52.73,313,92
1400000US06037301502,6037301502,2016,648,487,75.150002,406,81
1400000US06037301602,6037301602,2016,648,127,19.6,87,40
1400000US06037301801,6037301801,2016,576,420,72.919998,342,78
1400000US06037301902,6037301902,2016,897,570,63.549999,463,107
1400000US06037302002,6037302002,2016,170,103,60.59,88,15
1400000US06037302004,6037302004,2016,496,412,83.059998,350,62
1400000US06037302104,6037302104,2016,2370,1631,68.82,1321,310
1400000US06037302302,6037302302,2016,886,556,62.75,453,103
1400000US06037302504,6037302504,2016,2296,1881,81.93,1620,261
1400000US06037302505,6037302505,2016,405,337,83.209999,294,43
1400000US06037310201,6037310201,2016,599,180,30.049999,146,34
1400000US06037310300,6037310300,2016,2202,626,28.43,494,132
1400000US06037310601,6037310601,2016,427,213,49.880001,174,39
1400000US06037310602,6037310602,2016,2507,861,34.34,686,175
1400000US06037310703,6037310703,2016,734,318,43.32,253,65
1400000US06037310705,6037310705,2016,19,10,52.630001,10,0
1400000US06037310800,6037310800,2016,2930,855,29.18,642,213
1400000US06037310900,6037310900,2016,1383,678,49.02,562,116
1400000US06037311000,6037311000,2016,1003,387,38.580002,298,89
1400000US06037311100,6037311100,2016,1057,375,35.48,282,93
1400000US06037311200,6037311200,2016,25,3,12,3,0
1400000US06037311500,6037311500,2016,1196,176,14.72,124,52
1400000US06037311700,6037311700,2016,1029,324,31.49,254,70
1400000US06037311802,6037311802,2016,446,221,49.549999,176,45
1400000US06037320101,6037320101,2016,616,506,82.139999,402,104
1400000US06037320102,6037320102,2016,1899,1595,83.989998,1300,295
1400000US06037320201,6037320201,2016,1590,1370,86.160004,1175,195
1400000US06037320202,6037320202,2016,616,573,93.019997,465,108
1400000US06037320300,6037320300,2016,2151,1863,86.610001,1627,236
1400000US06037400205,6037400205,2016,88,75,85.230003,75,0
1400000US06037400208,6037400208,2016,591,57,9.6400003,45,12
1400000US06037400304,6037400304,2016,1027,513,49.950001,424,89
1400000US06037400402,6037400402,2016,2459,522,21.23,380,142
1400000US06037400403,6037400403,2016,50,32,64,32,0
1400000US06037400404,6037400404,2016,607,106,17.459999,72,34
1400000US06037400501,6037400501,2016,942,146,15.5,107,39
1400000US06037400602,6037400602,2016,705,490,69.5,401,89
1400000US06037400605,6037400605,2016,286,235,82.169998,212,23
1400000US06037400801,6037400801,2016,2200,936,42.549999,713,223
1400000US06037401001,6037401001,2016,676,142,21.01,103,39
1400000US06037401202,6037401202,2016,902,387,42.900002,303,84
1400000US06037401203,6037401203,2016,124,61,49.189999,52,9
1400000US06037401311,6037401311,2016,1171,343,29.290001,254,89
1400000US06037401312,6037401312,2016,2279,804,35.279999,624,180
1400000US06037401601,6037401601,2016,492,102,20.73,71,31
1400000US06037401602,6037401602,2016,2703,990,36.630001,759,231
1400000US06037401705,6037401705,2016,572,270,47.200001,230,40
1400000US06037401707,6037401707,2016,378,336,88.889999,286,50
1400000US06037401801,6037401801,2016,659,130,19.73,107,23
1400000US06037401802,6037401802,2016,2996,929,31.01,742,187
1400000US06037401902,6037401902,2016,1980,777,39.240002,635,142
1400000US06037402001,6037402001,2016,319,248,77.739998,206,42
1400000US06037402002,6037402002,2016,359,212,59.049999,169,43
1400000US06037402101,6037402101,2016,347,323,93.080002,296,27
1400000US06037402102,6037402102,2016,2251,1967,87.379997,1697,270
1400000US06037402200,6037402200,2016,265,214,80.75,190,24
1400000US06037402301,6037402301,2016,1327,1187,89.449997,1043,144
1400000US06037402303,6037402303,2016,438,409,93.379997,366,43
1400000US06037402403,6037402403,2016,953,499,52.360001,409,90
1400000US06037402405,6037402405,2016,1018,897,88.110001,768,129
1400000US06037402406,6037402406,2016,1054,992,94.120003,901,91
1400000US06037402501,6037402501,2016,1301,1257,96.620003,1150,107
1400000US06037402503,6037402503,2016,925,864,93.410004,785,79
1400000US06037402504,6037402504,2016,573,549,95.809998,492,57
1400000US06037402601,6037402601,2016,652,613,94.019997,559,54
1400000US06037402702,6037402702,2016,989,896,90.599998,806,90
1400000US06037402703,6037402703,2016,293,260,88.739998,218,42
1400000US06037402705,6037402705,2016,607,579,95.389999,544,35
1400000US06037402706,6037402706,2016,264,251,95.080002,226,25
1400000US06037402902,6037402902,2016,730,690,94.519997,628,62
1400000US06037402903,6037402903,2016,1736,1639,94.410004,1458,181
1400000US06037403000,6037403000,2016,3152,2863,90.830002,2533,330
1400000US06037403316,6037403316,2016,1070,616,57.57,483,133
1400000US06037403317,6037403317,2016,2133,1104,51.759998,853,251
1400000US06037403318,6037403318,2016,522,336,64.370003,277,59
1400000US06037403320,6037403320,2016,371,138,37.200001,114,24
1400000US06037403321,6037403321,2016,378,246,65.080002,195,51
1400000US06037403323,6037403323,2016,1740,238,13.68,161,77
1400000US06037403324,6037403324,2016,663,89,13.42,63,26
1400000US06037403325,6037403325,2016,4183,433,10.35,305,128
1400000US06037403326,6037403326,2016,603,134,22.219999,97,37
1400000US06037403327,6037403327,2016,417,228,54.68,193,35
1400000US06037403401,6037403401,2016,458,110,24.02,89,21
1400000US06037403402,6037403402,2016,3197,512,16.02,347,165
1400000US06037403404,6037403404,2016,1307,211,16.139999,143,68
1400000US06037403407,6037403407,2016,603,60,9.9499998,36,24
1400000US06037403408,6037403408,2016,1080,392,36.299999,277,115
1400000US06037403409,6037403409,2016,591,100,16.92,71,29
1400000US06037403601,6037403601,2016,811,514,63.380001,396,118
1400000US06037403702,6037403702,2016,2032,1079,53.099998,865,214
1400000US06037403703,6037403703,2016,423,266,62.880001,214,52
1400000US06037403722,6037403722,2016,712,424,59.549999,340,84
1400000US06037403801,6037403801,2016,1220,850,69.669998,690,160
1400000US06037403901,6037403901,2016,48,26,54.169998,25,1
1400000US06037403902,6037403902,2016,429,246,57.34,195,51
1400000US06037404000,6037404000,2016,847,689,81.349998,599,90
1400000US06037404100,6037404100,2016,510,432,84.709999,380,52
1400000US06037404201,6037404201,2016,2136,1650,77.25,1401,249
1400000US06037404203,6037404203,2016,243,208,85.599998,183,25
1400000US06037404401,6037404401,2016,786,614,78.120003,512,102
1400000US06037404402,6037404402,2016,719,626,87.07,542,84
1400000US06037404503,6037404503,2016,301,266,88.370003,226,40
1400000US06037404504,6037404504,2016,451,410,90.910004,383,27
1400000US06037404600,6037404600,2016,1459,1144,78.410004,905,239
1400000US06037404701,6037404701,2016,971,887,91.349998,787,100
1400000US06037404702,6037404702,2016,766,677,88.379997,596,81
1400000US06037404804,6037404804,2016,2758,2397,86.910004,2016,381
1400000US06037404805,6037404805,2016,528,475,89.959999,414,61
1400000US06037404806,6037404806,2016,1158,1025,88.510002,886,139
1400000US06037404901,6037404901,2016,581,491,84.510002,423,68
1400000US06037404903,6037404903,2016,544,475,87.32,413,62
1400000US06037405001,6037405001,2016,1001,855,85.410004,732,123
1400000US06037405002,6037405002,2016,437,407,93.139999,385,22
1400000US06037405101,6037405101,2016,1805,1565,86.699997,1379,186
1400000US06037405201,6037405201,2016,2442,2115,86.610001,1792,323
1400000US06037405202,6037405202,2016,781,697,89.239998,616,81
1400000US06037405302,6037405302,2016,517,430,83.169998,343,87
1400000US06037405400,6037405400,2016,230,181,78.699997,139,42
1400000US06037405600,6037405600,2016,979,701,71.599998,561,140
1400000US06037405701,6037405701,2016,1220,975,79.919998,807,168
1400000US06037405702,6037405702,2016,1319,978,74.150002,780,198
1400000US06037405800,6037405800,2016,1854,1391,75.029999,1163,228
1400000US06037406000,6037406000,2016,1927,1407,73.019997,1101,306
1400000US06037406103,6037406103,2016,587,409,69.68,332,77
1400000US06037406201,6037406201,2016,1374,1038,75.550003,830,208
1400000US06037406300,6037406300,2016,2289,1266,55.310001,918,348
1400000US06037406413,6037406413,2016,1377,901,65.43,702,199
1400000US06037406601,6037406601,2016,3919,2688,68.589996,2064,624
1400000US06037406602,6037406602,2016,354,277,78.25,216,61
1400000US06037406701,6037406701,2016,388,301,77.580002,240,61
1400000US06037406702,6037406702,2016,270,221,81.849998,186,35
1400000US06037406801,6037406801,2016,1937,1389,71.709999,1047,342
1400000US06037406903,6037406903,2016,2337,1556,66.580002,1244,312
1400000US06037407001,6037407001,2016,416,392,94.230003,352,40
1400000US06037407002,6037407002,2016,659,609,92.410004,549,60
1400000US06037407101,6037407101,2016,1950,1715,87.949997,1547,168
1400000US06037407201,6037407201,2016,353,323,91.5,296,27
1400000US06037407301,6037407301,2016,383,354,92.43,315,39
1400000US06037407302,6037407302,2016,1252,1161,92.730003,1018,143
1400000US06037407501,6037407501,2016,911,767,84.190002,638,129
1400000US06037407502,6037407502,2016,692,616,89.019997,548,68
1400000US06037407602,6037407602,2016,728,680,93.410004,612,68
1400000US06037407701,6037407701,2016,557,520,93.360001,482,38
1400000US06037407702,6037407702,2016,1652,1441,87.230003,1264,177
1400000US06037407801,6037407801,2016,621,550,88.57,484,66
1400000US06037407802,6037407802,2016,1401,1234,88.080002,1067,167
1400000US06037407901,6037407901,2016,527,446,84.629997,401,45
1400000US06037408003,6037408003,2016,112,90,80.360001,86,4
1400000US06037408135,6037408135,2016,581,522,89.849998,473,49
1400000US06037408136,6037408136,2016,384,315,82.029999,278,37
1400000US06037408137,6037408137,2016,805,548,68.07,448,100
1400000US06037408138,6037408138,2016,495,456,92.120003,412,44
1400000US06037408139,6037408139,2016,491,438,89.209999,398,40
1400000US06037408140,6037408140,2016,626,557,88.980003,500,57
1400000US06037408141,6037408141,2016,2457,1944,79.120003,1709,235
1400000US06037408212,6037408212,2016,671,327,48.73,240,87
1400000US06037408213,6037408213,2016,404,341,84.410004,301,40
1400000US06037408301,6037408301,2016,492,460,93.5,421,39
1400000US06037408302,6037408302,2016,608,406,66.779999,329,77
1400000US06037408401,6037408401,2016,13,7,53.849998,5,2
1400000US06037408402,6037408402,2016,1112,909,81.739998,760,149
1400000US06037408503,6037408503,2016,829,409,49.34,305,104
1400000US06037408504,6037408504,2016,586,348,59.389999,277,71
1400000US06037408505,6037408505,2016,2301,1611,70.010002,1307,304
1400000US06037408623,6037408623,2016,1958,1035,52.860001,807,228
1400000US06037408624,6037408624,2016,284,235,82.75,190,45
1400000US06037408625,6037408625,2016,1678,651,38.799999,478,173
1400000US06037408631,6037408631,2016,554,431,77.800003,347,84
1400000US06037408705,6037408705,2016,3191,1705,53.43,1304,401
1400000US06037408707,6037408707,2016,917,153,16.68,117,36
1400000US06037408722,6037408722,2016,665,296,44.509998,220,76
1400000US06037408724,6037408724,2016,511,452,88.449997,406,46
1400000US06037408725,6037408725,2016,795,487,61.259998,393,94
1400000US06037408800,6037408800,2016,14,12,85.709999,12,0
1400000US06037408900,6037408900,2016,1807,678,37.52,506,172
1400000US06037409000,6037409000,2016,528,463,87.690002,415,48
1400000US06037409100,6037409100,2016,208,174,83.650002,153,21
1400000US06037430003,6037430003,2016,376,211,56.119999,155,56
1400000US06037430005,6037430005,2016,332,271,81.629997,231,40
1400000US06037430101,6037430101,2016,1780,1371,77.019997,1081,290
1400000US06037430102,6037430102,2016,349,284,81.379997,242,42
1400000US06037430200,6037430200,2016,500,274,54.799999,202,72
1400000US06037430302,6037430302,2016,540,261,48.330002,211,50
1400000US06037430400,6037430400,2016,1465,234,15.97,150,84
1400000US06037430502,6037430502,2016,1112,242,21.76,181,61
1400000US06037430701,6037430701,2016,550,136,24.73,109,27
1400000US06037430721,6037430721,2016,3333,758,22.74,501,257
1400000US06037430801,6037430801,2016,793,194,24.459999,143,51
1400000US06037430802,6037430802,2016,1354,329,24.299999,222,107
1400000US06037431002,6037431002,2016,652,426,65.339996,336,90
1400000US06037431003,6037431003,2016,1712,834,48.709999,634,200
1400000US06037431004,6037431004,2016,1753,1102,62.860001,873,229
1400000US06037431100,6037431100,2016,619,441,71.239998,341,100
1400000US06037431200,6037431200,2016,365,319,87.400002,282,37
1400000US06037431400,6037431400,2016,383,301,78.589996,237,64
1400000US06037431501,6037431501,2016,393,276,70.230003,225,51
1400000US06037431502,6037431502,2016,825,647,78.419998,555,92
1400000US06037431600,6037431600,2016,475,132,27.790001,96,36
1400000US06037431701,6037431701,2016,1397,303,21.690001,214,89
1400000US06037431800,6037431800,2016,2066,769,37.220001,513,256
1400000US06037431900,6037431900,2016,1067,385,36.080002,281,104
1400000US06037432002,6037432002,2016,490,199,40.610001,135,64
1400000US06037432102,6037432102,2016,598,282,47.16,206,76
1400000US06037432201,6037432201,2016,516,386,74.809998,290,96
1400000US06037432202,6037432202,2016,2705,2273,84.029999,1769,504
1400000US06037432300,6037432300,2016,913,815,89.269997,724,91
1400000US06037432401,6037432401,2016,3099,2724,87.900002,2293,431
1400000US06037432402,6037432402,2016,480,447,93.129997,402,45
1400000US06037432501,6037432501,2016,416,322,77.400002,274,48
1400000US06037432602,6037432602,2016,1365,1161,85.050003,1042,119
1400000US06037432801,6037432801,2016,598,574,95.989998,558,16
1400000US06037432902,6037432902,2016,452,375,82.959999,292,83
1400000US06037433103,6037433103,2016,416,406,97.599998,375,31
1400000US06037433200,6037433200,2016,3025,2855,94.379997,2546,309
1400000US06037433302,6037433302,2016,844,772,91.470001,672,100
1400000US06037433305,6037433305,2016,643,588,91.449997,548,40
1400000US06037433306,6037433306,2016,464,437,94.18,410,27
1400000US06037433307,6037433307,2016,732,633,86.480003,551,82
1400000US06037433505,6037433505,2016,1419,1375,96.900002,1312,63
1400000US06037433803,6037433803,2016,2007,1771,88.239998,1524,247
1400000US06037433804,6037433804,2016,1217,1060,87.099998,969,91
1400000US06037433901,6037433901,2016,510,461,90.389999,431,30
1400000US06037433903,6037433903,2016,1311,1170,89.239998,1101,69
1400000US06037434001,6037434001,2016,1381,1314,95.150002,1125,189
1400000US06037434003,6037434003,2016,1349,1242,92.07,1135,107
1400000US06037434100,6037434100,2016,502,427,85.059998,352,75
1400000US06037460002,6037460002,2016,608,248,40.790001,184,64
1400000US06037460101,6037460101,2016,416,49,11.78,27,22
1400000US06037460200,6037460200,2016,185,98,52.970001,69,29
1400000US06037460301,6037460301,2016,402,130,32.34,100,30
1400000US06037460302,6037460302,2016,723,351,48.549999,290,61
1400000US06037460501,6037460501,2016,717,12,1.67,10,2
1400000US06037460502,6037460502,2016,650,14,2.1500001,10,4
1400000US06037460601,6037460601,2016,614,12,1.95,12,0
1400000US06037460700,6037460700,2016,2037,29,1.42,27,2
1400000US06037460900,6037460900,2016,1040,821,78.940002,738,83
1400000US06037461000,6037461000,2016,497,398,80.080002,353,45
1400000US06037461100,6037461100,2016,285,238,83.510002,216,22
1400000US06037461200,6037461200,2016,440,369,83.860001,333,36
1400000US06037461300,6037461300,2016,467,285,61.029999,234,51
1400000US06037461400,6037461400,2016,513,426,83.040001,371,55
1400000US06037461502,6037461502,2016,1101,962,87.379997,881,81
1400000US06037461700,6037461700,2016,346,318,91.910004,291,27
1400000US06037462100,6037462100,2016,480,456,95,416,40
1400000US06037462500,6037462500,2016,2378,1443,60.68,1111,332
1400000US06037462600,6037462600,2016,1946,1226,63,958,268
1400000US06037462700,6037462700,2016,374,340,90.910004,294,46
1400000US06037462900,6037462900,2016,136,126,92.650002,120,6
1400000US06037463000,6037463000,2016,2453,1797,73.260002,1515,282
1400000US06037463200,6037463200,2016,1175,857,72.940002,701,156
1400000US06037463300,6037463300,2016,590,312,52.880001,206,106
1400000US06037463601,6037463601,2016,1115,723,64.839996,605,118
1400000US06037463800,6037463800,2016,454,163,35.900002,120,43
1400000US06037464000,6037464000,2016,940,631,67.129997,521,110
1400000US06037464101,6037464101,2016,1332,50,3.75,41,9
1400000US06037464200,6037464200,2016,1149,44,3.8299999,30,14
1400000US06037480002,6037480002,2016,941,150,15.94,104,46
1400000US06037480012,6037480012,2016,1579,599,37.939999,403,196
1400000US06037480201,6037480201,2016,391,166,42.459999,133,33
1400000US06037480202,6037480202,2016,479,235,49.060001,175,60
1400000US06037480302,6037480302,2016,468,342,73.080002,287,55
1400000US06037480304,6037480304,2016,3269,2420,74.029999,1889,531
1400000US06037480400,6037480400,2016,1742,1155,66.300003,876,279
1400000US06037480500,6037480500,2016,1851,282,15.24,209,73
1400000US06037480702,6037480702,2016,624,61,9.7799997,40,21
1400000US06037480703,6037480703,2016,690,71,10.29,48,23
1400000US06037480704,6037480704,2016,1484,230,15.5,148,82
1400000US06037480803,6037480803,2016,469,326,69.510002,269,57
1400000US06037480804,6037480804,2016,773,526,68.050003,407,119
1400000US06037480901,6037480901,2016,203,123,60.59,115,8
1400000US06037480903,6037480903,2016,587,455,77.510002,365,90
1400000US06037481101,6037481101,2016,907,671,73.980003,527,144
1400000US06037481102,6037481102,2016,43,34,79.07,32,2
1400000US06037481103,6037481103,2016,2225,1741,78.25,1419,322
1400000US06037481203,6037481203,2016,1578,878,55.639999,714,164
1400000US06037481300,6037481300,2016,589,484,82.169998,351,133
1400000US06037481401,6037481401,2016,578,403,69.720001,301,102
1400000US06037481403,6037481403,2016,381,318,83.459999,273,45
1400000US06037481404,6037481404,2016,1789,964,53.880001,722,242
1400000US06037481500,6037481500,2016,2278,1310,57.509998,1019,291
1400000US06037481606,6037481606,2016,868,673,77.529999,520,153
1400000US06037481901,6037481901,2016,562,410,72.949997,323,87
1400000US06037482001,6037482001,2016,1044,592,56.700001,448,144
1400000US06037482002,6037482002,2016,960,366,38.130001,274,92
1400000US06037482101,6037482101,2016,899,689,76.639999,554,135
1400000US06037482102,6037482102,2016,789,434,55.009998,322,112
1400000US06037482202,6037482202,2016,474,351,74.050003,302,49
1400000US06037482304,6037482304,2016,519,465,89.599998,406,59
1400000US06037482401,6037482401,2016,438,348,79.449997,312,36
1400000US06037482403,6037482403,2016,1398,1172,83.830002,1019,153
1400000US06037482502,6037482502,2016,1239,991,79.980003,877,114
1400000US06037482522,6037482522,2016,418,285,68.18,216,69
1400000US06037482600,6037482600,2016,389,236,60.669998,199,37
1400000US06037482701,6037482701,2016,588,494,84.010002,415,79
1400000US06037482801,6037482801,2016,908,706,77.75,568,138
1400000US06037500202,6037500202,2016,4077,1917,47.02,1374,543
1400000US06037500203,6037500203,2016,559,102,18.25,68,34
1400000US06037500300,6037500300,2016,445,307,68.989998,246,61
1400000US06037500402,6037500402,2016,724,559,77.209999,485,74
1400000US06037500404,6037500404,2016,398,273,68.589996,234,39
1400000US06037500600,6037500600,2016,847,724,85.480003,623,101
1400000US06037500700,6037500700,2016,439,342,77.900002,295,47
1400000US06037500800,6037500800,2016,3130,2325,74.279999,1920,405
1400000US06037500900,6037500900,2016,551,458,83.120003,409,49
1400000US06037501001,6037501001,2016,361,322,89.199997,284,38
1400000US06037501002,6037501002,2016,1217,1038,85.290001,911,127
1400000US06037501200,6037501200,2016,384,315,82.029999,276,39
1400000US06037501302,6037501302,2016,1601,1286,80.32,1141,145
1400000US06037501400,6037501400,2016,2051,1532,74.699997,1229,303
1400000US06037501600,6037501600,2016,457,363,79.43,306,57
1400000US06037501700,6037501700,2016,765,242,31.629999,173,69
1400000US06037501804,6037501804,2016,427,390,91.330002,357,33
1400000US06037502003,6037502003,2016,452,398,88.050003,338,60
1400000US06037502005,6037502005,2016,677,472,69.720001,396,76
1400000US06037502200,6037502200,2016,484,394,81.400002,349,45
1400000US06037502303,6037502303,2016,2707,2371,87.589996,2015,356
1400000US06037502401,6037502401,2016,1442,1084,75.169998,880,204
1400000US06037502602,6037502602,2016,429,341,79.489998,296,45
1400000US06037502603,6037502603,2016,575,417,72.519997,325,92
1400000US06037502604,6037502604,2016,458,342,74.669998,281,61
1400000US06037502700,6037502700,2016,862,659,76.449997,532,127
1400000US06037502801,6037502801,2016,3770,2644,70.129997,1788,856
1400000US06037503103,6037503103,2016,523,493,94.260002,441,52
1400000US06037503105,6037503105,2016,660,596,90.300003,510,86
1400000US06037503201,6037503201,2016,372,257,69.089996,200,57
1400000US06037503202,6037503202,2016,400,335,83.75,284,51
1400000US06037503302,6037503302,2016,3364,2439,72.5,1935,504
1400000US06037503402,6037503402,2016,655,225,34.349998,166,59
1400000US06037503501,6037503501,2016,1095,689,62.919998,574,115
1400000US06037503502,6037503502,2016,638,428,67.080002,337,91
1400000US06037503602,6037503602,2016,2560,1259,49.18,1019,240
1400000US06037503701,6037503701,2016,1724,732,42.459999,548,184
1400000US06037503705,6037503705,2016,221,112,50.68,97,15
1400000US06037503801,6037503801,2016,1335,582,43.599998,513,69
1400000US06037503802,6037503802,2016,466,223,47.849998,178,45
1400000US06037503902,6037503902,2016,590,254,43.049999,191,63
1400000US06037504002,6037504002,2016,1364,662,48.529999,553,109
1400000US06037504101,6037504101,2016,347,279,80.400002,247,32
1400000US06037504200,6037504200,2016,2038,1730,84.889999,1532,198
1400000US06037530005,6037530005,2016,2794,2261,80.919998,1811,450
1400000US06037530007,6037530007,2016,2088,1739,83.290001,1515,224
1400000US06037530101,6037530101,2016,479,440,91.860001,396,44
1400000US06037530102,6037530102,2016,4578,3959,86.480003,3415,544
1400000US06037530202,6037530202,2016,884,811,91.739998,723,88
1400000US06037530203,6037530203,2016,629,566,89.980003,497,69
1400000US06037530301,6037530301,2016,3698,3315,89.639999,2838,477
1400000US06037530400,6037530400,2016,1621,1426,87.970001,1188,238
1400000US06037530500,6037530500,2016,752,684,90.959999,592,92
1400000US06037530603,6037530603,2016,780,632,81.029999,553,79
1400000US06037530700,6037530700,2016,591,527,89.169998,444,83
1400000US06037530801,6037530801,2016,478,455,95.190002,411,44
1400000US06037530902,6037530902,2016,738,682,92.410004,621,61
1400000US06037531000,6037531000,2016,2905,2635,90.709999,2371,264
1400000US06037531101,6037531101,2016,2785,2215,79.529999,1993,222
1400000US06037531102,6037531102,2016,1201,1107,92.169998,1012,95
1400000US06037531201,6037531201,2016,899,796,88.540001,732,64
1400000US06037531202,6037531202,2016,169,161,95.269997,140,21
1400000US06037531302,6037531302,2016,1167,1063,91.089996,949,114
1400000US06037531502,6037531502,2016,1059,967,91.309998,885,82
1400000US06037531503,6037531503,2016,677,630,93.059998,560,70
1400000US06037531603,6037531603,2016,1445,1296,89.690002,1139,157
1400000US06037531701,6037531701,2016,548,500,91.239998,421,79
1400000US06037531702,6037531702,2016,631,548,86.849998,517,31
1400000US06037531800,6037531800,2016,833,754,90.519997,699,55
1400000US06037531902,6037531902,2016,587,547,93.190002,491,56
1400000US06037532002,6037532002,2016,559,467,83.540001,391,76
1400000US06037532101,6037532101,2016,64,34,53.130001,31,3
1400000US06037532102,6037532102,2016,974,818,83.980003,750,68
1400000US06037532200,6037532200,2016,263,219,83.269997,198,21
1400000US06037532302,6037532302,2016,520,399,76.730003,351,48
1400000US06037532303,6037532303,2016,861,622,72.239998,501,121
1400000US06037532500,6037532500,2016,3345,3002,89.75,2640,362
1400000US06037532605,6037532605,2016,373,366,98.120003,314,52
1400000US06037532607,6037532607,2016,1847,1652,89.440002,1475,177
1400000US06037532700,6037532700,2016,816,776,95.099998,704,72
1400000US06037532800,6037532800,2016,2744,2517,91.730003,2362,155
1400000US06037532900,6037532900,2016,2020,1917,94.900002,1782,135
1400000US06037533103,6037533103,2016,3077,2858,92.879997,2563,295
1400000US06037533108,6037533108,2016,2678,2446,91.339996,2164,282
1400000US06037533201,6037533201,2016,632,589,93.199997,497,92
1400000US06037533204,6037533204,2016,589,539,91.510002,474,65
1400000US06037533402,6037533402,2016,1537,1419,92.32,1245,174
1400000US06037533403,6037533403,2016,1806,1605,88.870003,1339,266
1400000US06037533501,6037533501,2016,1814,1625,89.580002,1395,230
1400000US06037533504,6037533504,2016,887,804,90.639999,682,122
1400000US06037533601,6037533601,2016,1017,919,90.360001,787,132
1400000US06037533602,6037533602,2016,2549,2343,91.919998,2038,305
1400000US06037533603,6037533603,2016,2950,2640,89.489998,2266,374
1400000US06037533703,6037533703,2016,682,624,91.5,527,97
1400000US06037533804,6037533804,2016,759,664,87.480003,584,80
1400000US06037533901,6037533901,2016,3923,3565,90.870003,3152,413
1400000US06037533902,6037533902,2016,743,623,83.849998,573,50
1400000US06037534001,6037534001,2016,855,748,87.489998,684,64
1400000US06037534002,6037534002,2016,1005,914,90.949997,821,93
1400000US06037534102,6037534102,2016,1184,1023,86.400002,937,86
1400000US06037534201,6037534201,2016,1029,932,90.57,862,70
1400000US06037534302,6037534302,2016,550,505,91.82,448,57
1400000US06037534404,6037534404,2016,1451,1349,92.970001,1177,172
1400000US06037534405,6037534405,2016,1738,1540,88.610001,1388,152
1400000US06037534406,6037534406,2016,1410,1245,88.300003,1109,136
1400000US06037534501,6037534501,2016,1104,998,90.400002,844,154
1400000US06037534803,6037534803,2016,767,739,96.349998,662,77
1400000US06037534804,6037534804,2016,448,436,97.32,380,56
1400000US06037534900,6037534900,2016,2312,2120,91.699997,1843,277
1400000US06037535001,6037535001,2016,1805,1705,94.459999,1590,115
1400000US06037535101,6037535101,2016,2356,2202,93.459999,2024,178
1400000US06037535102,6037535102,2016,701,663,94.580002,614,49
1400000US06037535300,6037535300,2016,1067,990,92.779999,891,99
1400000US06037535501,6037535501,2016,570,523,91.75,460,63
1400000US06037535603,6037535603,2016,548,500,91.239998,437,63
1400000US06037535604,6037535604,2016,559,529,94.629997,477,52
1400000US06037535605,6037535605,2016,743,684,92.059998,606,78
1400000US06037535607,6037535607,2016,4007,3634,90.690002,3085,549
1400000US06037535701,6037535701,2016,721,663,91.959999,591,72
1400000US06037535702,6037535702,2016,3531,3132,88.699997,2659,473
1400000US06037535803,6037535803,2016,473,442,93.449997,378,64
1400000US06037535901,6037535901,2016,1800,1534,85.220001,1262,272
1400000US06037536000,6037536000,2016,2878,2541,88.290001,2125,416
1400000US06037536103,6037536103,2016,658,587,89.209999,498,89
1400000US06037536104,6037536104,2016,1829,1600,87.480003,1306,294
1400000US06037536201,6037536201,2016,1062,957,90.110001,839,118
1400000US06037540000,6037540000,2016,2747,2446,89.040001,2231,215
1400000US06037540101,6037540101,2016,3471,3209,92.449997,2859,350
1400000US06037540102,6037540102,2016,1,1,100,1,0
1400000US06037540202,6037540202,2016,2007,1914,95.370003,1766,148
1400000US06037540203,6037540203,2016,610,586,96.07,529,57
1400000US06037540300,6037540300,2016,532,500,93.980003,445,55
1400000US06037540400,6037540400,2016,345,332,96.230003,310,22
1400000US06037540502,6037540502,2016,811,769,94.82,713,56
1400000US06037540600,6037540600,2016,501,427,85.230003,402,25
1400000US06037540700,6037540700,2016,2552,2188,85.739998,1930,258
1400000US06037540800,6037540800,2016,1297,1211,93.370003,1148,63
1400000US06037540901,6037540901,2016,709,662,93.370003,593,69
1400000US06037540902,6037540902,2016,503,415,82.5,368,47
1400000US06037541003,6037541003,2016,480,366,76.25,287,79
1400000US06037541100,6037541100,2016,404,349,86.389999,330,19
1400000US06037541200,6037541200,2016,902,748,82.93,704,44
1400000US06037541300,6037541300,2016,1279,1033,80.769997,966,67
1400000US06037541401,6037541401,2016,472,420,88.980003,388,32
1400000US06037541500,6037541500,2016,768,669,87.110001,628,41
1400000US06037541603,6037541603,2016,897,831,92.639999,780,51
1400000US06037541605,6037541605,2016,640,543,84.839996,521,22
1400000US06037541700,6037541700,2016,3597,3366,93.580002,3116,250
1400000US06037541802,6037541802,2016,718,666,92.760002,600,66
1400000US06037542000,6037542000,2016,1590,1293,81.32,1241,52
1400000US06037542104,6037542104,2016,633,578,91.309998,545,33
1400000US06037542106,6037542106,2016,2969,2457,82.760002,2279,178
1400000US06037542200,6037542200,2016,825,690,83.639999,660,30
1400000US06037542402,6037542402,2016,2848,2385,83.739998,2236,149
1400000US06037542601,6037542601,2016,462,386,83.550003,363,23
1400000US06037542700,6037542700,2016,1513,1342,88.699997,1287,55
1400000US06037542800,6037542800,2016,541,451,83.360001,413,38
1400000US06037542900,6037542900,2016,647,517,79.910004,459,58
1400000US06037543000,6037543000,2016,831,715,86.040001,653,62
1400000US06037543100,6037543100,2016,817,684,83.720001,640,44
1400000US06037543201,6037543201,2016,626,558,89.139999,519,39
1400000US06037543203,6037543203,2016,285,261,91.580002,237,24
1400000US06037543304,6037543304,2016,283,208,73.5,173,35
1400000US06037543306,6037543306,2016,376,269,71.540001,219,50
1400000US06037543321,6037543321,2016,674,289,42.880001,201,88
1400000US06037543322,6037543322,2016,1060,826,77.919998,703,123
1400000US06037543400,6037543400,2016,347,302,87.029999,246,56
1400000US06037543501,6037543501,2016,1610,1224,76.019997,1006,218
1400000US06037543503,6037543503,2016,1127,915,81.190002,804,111
1400000US06037543601,6037543601,2016,947,643,67.900002,491,152
1400000US06037543607,6037543607,2016,429,283,65.970001,212,71
1400000US06037543701,6037543701,2016,3121,2129,68.220001,1684,445
1400000US06037543705,6037543705,2016,544,475,87.32,403,72
1400000US06037543801,6037543801,2016,685,493,71.970001,409,84
1400000US06037543903,6037543903,2016,1452,1041,71.690002,843,198
1400000US06037544001,6037544001,2016,552,465,84.239998,365,100
1400000US06037544002,6037544002,2016,984,757,76.93,615,142
1400000US06037550101,6037550101,2016,277,206,74.370003,139,67
1400000US06037550201,6037550201,2016,271,202,74.540001,152,50
1400000US06037550202,6037550202,2016,367,280,76.290001,224,56
1400000US06037550301,6037550301,2016,471,326,69.209999,246,80
1400000US06037550501,6037550501,2016,671,468,69.75,348,120
1400000US06037550602,6037550602,2016,694,374,53.889999,265,109
1400000US06037550700,6037550700,2016,2225,1381,62.07,1016,365
1400000US06037550801,6037550801,2016,809,545,67.370003,405,140
1400000US06037550901,6037550901,2016,4207,2717,64.580002,1987,730
1400000US06037551001,6037551001,2016,823,455,55.290001,345,110
1400000US06037551002,6037551002,2016,1395,853,61.150002,629,224
1400000US06037551101,6037551101,2016,614,543,88.440002,464,79
1400000US06037551102,6037551102,2016,228,157,68.860001,140,17
1400000US06037551201,6037551201,2016,529,400,75.610001,319,81
1400000US06037551203,6037551203,2016,1153,898,77.879997,702,196
1400000US06037551204,6037551204,2016,583,438,75.129997,357,81
1400000US06037551300,6037551300,2016,3647,2343,64.239998,1671,672
1400000US06037551402,6037551402,2016,730,499,68.360001,380,119
1400000US06037551501,6037551501,2016,2337,1739,74.410004,1331,408
1400000US06037551700,6037551700,2016,433,342,78.980003,288,54
1400000US06037551801,6037551801,2016,1192,615,51.59,516,99
1400000US06037551802,6037551802,2016,797,581,72.900002,444,137
1400000US06037551900,6037551900,2016,443,381,86,335,46
1400000US06037552001,6037552001,2016,394,339,86.040001,299,40
1400000US06037552100,6037552100,2016,3480,2907,83.529999,2552,355
1400000US06037552200,6037552200,2016,399,359,89.970001,329,30
1400000US06037552301,6037552301,2016,458,383,83.620003,334,49
1400000US06037552302,6037552302,2016,1404,1150,81.910004,1008,142
1400000US06037552601,6037552601,2016,481,436,90.639999,395,41
1400000US06037552602,6037552602,2016,597,524,87.769997,457,67
1400000US06037552700,6037552700,2016,672,603,89.730003,540,63
1400000US06037552800,6037552800,2016,2293,1868,81.470001,1616,252
1400000US06037553000,6037553000,2016,510,419,82.160004,353,66
1400000US06037553100,6037553100,2016,3142,2497,79.470001,1865,632
1400000US06037553300,6037553300,2016,493,401,81.339996,293,108
1400000US06037553502,6037553502,2016,6119,5618,91.809998,4963,655
1400000US06037553504,6037553504,2016,706,672,95.18,622,50
1400000US06037553601,6037553601,2016,606,580,95.709999,536,44
1400000US06037553701,6037553701,2016,602,571,94.849998,510,61
1400000US06037553702,6037553702,2016,1443,1348,93.419998,1243,105
1400000US06037553802,6037553802,2016,1203,1122,93.269997,1018,104
1400000US06037553901,6037553901,2016,1097,994,90.610001,881,113
1400000US06037553902,6037553902,2016,1663,1560,93.809998,1433,127
1400000US06037554002,6037554002,2016,717,626,87.309998,532,94
1400000US06037554106,6037554106,2016,596,525,88.089996,433,92
1400000US06037554201,6037554201,2016,832,670,80.529999,552,118
1400000US06037554405,6037554405,2016,774,577,74.550003,459,118
1400000US06037554511,6037554511,2016,2004,510,25.450001,360,150
1400000US06037554512,6037554512,2016,1561,367,23.51,241,126
1400000US06037554514,6037554514,2016,670,476,71.040001,416,60
1400000US06037554515,6037554515,2016,774,261,33.720001,189,72
1400000US06037554516,6037554516,2016,3906,1435,36.740002,1023,412
1400000US06037554517,6037554517,2016,739,127,17.190001,93,34
1400000US06037554518,6037554518,2016,667,118,17.690001,78,40
1400000US06037554521,6037554521,2016,1950,1023,52.459999,779,244
1400000US06037554522,6037554522,2016,1190,559,46.970001,424,135
1400000US06037554700,6037554700,2016,349,326,93.410004,304,22
1400000US06037554801,6037554801,2016,702,527,75.07,442,85
1400000US06037554802,6037554802,2016,1565,911,58.209999,702,209
1400000US06037555001,6037555001,2016,447,398,89.040001,356,42
1400000US06037555002,6037555002,2016,382,312,81.68,269,43
1400000US06037555105,6037555105,2016,2149,1606,74.730003,1370,236
1400000US06037555106,6037555106,2016,420,383,91.190002,343,40
1400000US06037555107,6037555107,2016,562,515,91.639999,464,51
1400000US06037555211,6037555211,2016,403,389,96.529999,360,29
1400000US06037555212,6037555212,2016,411,399,97.080002,369,30
1400000US06037555300,6037555300,2016,405,298,73.580002,212,86
1400000US06037570001,6037570001,2016,3867,2067,53.450001,1442,625
1400000US06037570002,6037570002,2016,746,618,82.839996,473,145
1400000US06037570100,6037570100,2016,538,494,91.82,456,38
1400000US06037570202,6037570202,2016,911,799,87.709999,703,96
1400000US06037570203,6037570203,2016,700,642,91.709999,581,61
1400000US06037570402,6037570402,2016,1298,1143,88.059998,1020,123
1400000US06037570403,6037570403,2016,744,695,93.410004,617,78
1400000US06037570504,6037570504,2016,4168,3310,79.410004,2844,466
1400000US06037570601,6037570601,2016,660,611,92.580002,532,79
1400000US06037570602,6037570602,2016,886,785,88.599998,677,108
1400000US06037570701,6037570701,2016,600,457,76.169998,396,61
1400000US06037570800,6037570800,2016,1324,659,49.77,467,192
1400000US06037570902,6037570902,2016,737,342,46.400002,250,92
1400000US06037571000,6037571000,2016,526,196,37.259998,154,42
1400000US06037571101,6037571101,2016,357,174,48.740002,146,28
1400000US06037571102,6037571102,2016,3316,1698,51.209999,1306,392
1400000US06037571202,6037571202,2016,1555,752,48.360001,583,169
1400000US06037571300,6037571300,2016,1299,841,64.739998,683,158
1400000US06037571400,6037571400,2016,451,214,47.450001,149,65
1400000US06037571502,6037571502,2016,600,540,90,479,61
1400000US06037571701,6037571701,2016,1854,1679,90.559998,1458,221
1400000US06037571703,6037571703,2016,916,867,94.650002,789,78
1400000US06037571800,6037571800,2016,523,210,40.150002,164,46
1400000US06037571900,6037571900,2016,2565,1334,52.009998,1062,272
1400000US06037572202,6037572202,2016,1619,1400,86.470001,1219,181
1400000US06037572500,6037572500,2016,592,520,87.839996,469,51
1400000US06037572600,6037572600,2016,844,756,89.57,663,93
1400000US06037572700,6037572700,2016,746,675,90.480003,573,102
1400000US06037573101,6037573101,2016,953,809,84.889999,741,68
1400000US06037573201,6037573201,2016,819,771,94.139999,682,89
1400000US06037573300,6037573300,2016,425,335,78.82,268,67
1400000US06037573402,6037573402,2016,1505,1326,88.110001,1144,182
1400000US06037573601,6037573601,2016,555,322,58.02,289,33
1400000US06037573700,6037573700,2016,759,192,25.299999,134,58
1400000US06037573800,6037573800,2016,784,323,41.200001,248,75
1400000US06037573902,6037573902,2016,884,201,22.74,153,48
1400000US06037574000,6037574000,2016,1020,301,29.51,233,68
1400000US06037574100,6037574100,2016,1398,551,39.41,446,105
1400000US06037574201,6037574201,2016,498,244,49,192,52
1400000US06037574202,6037574202,2016,231,196,84.849998,189,7
1400000US06037574300,6037574300,2016,1863,643,34.509998,495,148
1400000US06037574400,6037574400,2016,4158,1725,41.490002,1399,326
1400000US06037574500,6037574500,2016,785,356,45.349998,268,88
1400000US06037574602,6037574602,2016,340,241,70.879997,209,32
1400000US06037574901,6037574901,2016,572,118,20.629999,103,15
1400000US06037575002,6037575002,2016,365,283,77.529999,248,35
1400000US06037575101,6037575101,2016,942,784,83.230003,733,51
1400000US06037575201,6037575201,2016,1006,857,85.190002,820,37
1400000US06037575300,6037575300,2016,5330,3337,62.610001,2952,385
1400000US06037575401,6037575401,2016,1733,1455,83.959999,1352,103
1400000US06037575901,6037575901,2016,713,629,88.220001,606,23
1400000US06037576200,6037576200,2016,1139,960,84.279999,899,61
1400000US06037576301,6037576301,2016,1270,939,73.940002,855,84
1400000US06037576401,6037576401,2016,1096,964,87.959999,914,50
1400000US06037576501,6037576501,2016,1216,1116,91.779999,1041,75
1400000US06037576801,6037576801,2016,763,676,88.599998,610,66
1400000US06037576903,6037576903,2016,709,662,93.370003,611,51
1400000US06037577000,6037577000,2016,4805,3095,64.410004,2669,426
1400000US06037577100,6037577100,2016,883,420,47.57,330,90
1400000US06037577501,6037577501,2016,365,41,11.23,40,1
1400000US06037577602,6037577602,2016,332,112,33.73,94,18
1400000US06037577606,6037577606,2016,1607,285,17.73,229,56
1400000US06037577700,6037577700,2016,1115,886,79.459999,703,183
1400000US06037577800,6037577800,2016,654,488,74.620003,338,150
1400000US06037577900,6037577900,2016,407,264,64.860001,246,18
1400000US06037578000,6037578000,2016,3444,2787,80.919998,2417,370
1400000US06037599000,6037599000,2016,613,423,69,294,129
1400000US06037600201,6037600201,2016,943,898,95.230003,864,34
1400000US06037600302,6037600302,2016,1739,1542,88.669998,1432,110
1400000US06037600303,6037600303,2016,862,793,92,740,53
1400000US06037600501,6037600501,2016,356,318,89.330002,289,29
1400000US06037600602,6037600602,2016,1838,1343,73.07,1291,52
1400000US06037600703,6037600703,2016,627,573,91.389999,488,85
1400000US06037600801,6037600801,2016,541,426,78.739998,399,27
1400000US06037600911,6037600911,2016,681,500,73.419998,466,34
1400000US06037601001,6037601001,2016,96,94,97.919998,92,2
1400000US06037601002,6037601002,2016,825,650,78.790001,602,48
1400000US06037601202,6037601202,2016,1208,974,80.629997,907,67
1400000US06037601211,6037601211,2016,1613,868,53.810001,840,28
1400000US06037601212,6037601212,2016,390,371,95.129997,317,54
1400000US06037601301,6037601301,2016,648,413,63.73,368,45
1400000US06037601303,6037601303,2016,1272,929,73.029999,811,118
1400000US06037601401,6037601401,2016,713,465,65.220001,448,17
1400000US06037601402,6037601402,2016,701,521,74.32,484,37
1400000US06037601502,6037601502,2016,1450,1395,96.209999,1281,114
1400000US06037601600,6037601600,2016,2139,2052,95.93,1849,203
1400000US06037601700,6037601700,2016,2015,1900,94.290001,1639,261
1400000US06037601802,6037601802,2016,590,566,95.93,520,46
1400000US06037602003,6037602003,2016,463,349,75.379997,323,26
1400000US06037602104,6037602104,2016,598,541,90.470001,489,52
1400000US06037602106,6037602106,2016,1571,1336,85.040001,1165,171
1400000US06037602201,6037602201,2016,3565,2204,61.82,1791,413
1400000US06037602302,6037602302,2016,1887,864,45.790001,553,311
1400000US06037602402,6037602402,2016,744,548,73.660004,443,105
1400000US06037602403,6037602403,2016,1574,1383,87.870003,1243,140
1400000US06037602404,6037602404,2016,554,489,88.269997,435,54
1400000US06037602505,6037602505,2016,914,800,87.529999,709,91
1400000US06037602506,6037602506,2016,760,680,89.470001,628,52
1400000US06037602511,6037602511,2016,1872,1693,90.440002,1546,147
1400000US06037602601,6037602601,2016,494,421,85.220001,365,56
1400000US06037602700,6037602700,2016,515,460,89.32,417,43
1400000US06037602801,6037602801,2016,1227,1137,92.669998,1007,130
1400000US06037602802,6037602802,2016,1231,1144,92.93,1053,91
1400000US06037603006,6037603006,2016,361,330,91.410004,302,28
1400000US06037603008,6037603008,2016,764,649,84.949997,541,108
1400000US06037603101,6037603101,2016,0,0,,0,0
1400000US06037603200,6037603200,2016,1524,1242,81.5,1069,173
1400000US06037603301,6037603301,2016,2080,1644,79.040001,1347,297
1400000US06037603400,6037603400,2016,797,574,72.019997,446,128
1400000US06037603600,6037603600,2016,202,176,87.129997,150,26
1400000US06037603702,6037603702,2016,528,312,59.09,222,90
1400000US06037603705,6037603705,2016,107,84,78.5,82,2
1400000US06037603706,6037603706,2016,614,542,88.269997,466,76
1400000US06037603801,6037603801,2016,1732,1379,79.620003,1166,213
1400000US06037603802,6037603802,2016,1771,1446,81.650002,1224,222
1400000US06037603901,6037603901,2016,3385,2675,79.029999,2195,480
1400000US06037603902,6037603902,2016,917,701,76.440002,566,135
1400000US06037604001,6037604001,2016,503,406,80.720001,319,87
1400000US06037604002,6037604002,2016,757,603,79.660004,493,110
1400000US06037604200,6037604200,2016,1385,1161,83.830002,1022,139
1400000US06037620001,6037620001,2016,716,100,13.97,68,32
1400000US06037620002,6037620002,2016,835,117,14.01,94,23
1400000US06037620101,6037620101,2016,1837,221,12.03,170,51
1400000US06037620303,6037620303,2016,627,8,1.28,7,1
1400000US06037620305,6037620305,2016,718,9,1.25,9,0
1400000US06037620400,6037620400,2016,1980,60,3.03,53,7
1400000US06037620501,6037620501,2016,597,53,8.8800001,38,15
1400000US06037620521,6037620521,2016,447,97,21.700001,80,17
1400000US06037620602,6037620602,2016,1697,402,23.690001,307,95
1400000US06037620701,6037620701,2016,460,74,16.09,64,10
1400000US06037620703,6037620703,2016,639,33,5.1599998,26,7
1400000US06037620802,6037620802,2016,2896,140,4.8299999,102,38
1400000US06037620904,6037620904,2016,408,7,1.72,7,0
1400000US06037621005,6037621005,2016,1420,37,2.6099999,36,1
1400000US06037621201,6037621201,2016,4325,716,16.549999,536,180
1400000US06037621301,6037621301,2016,662,71,10.73,54,17
1400000US06037621400,6037621400,2016,497,68,13.68,55,13
1400000US06037650001,6037650001,2016,1162,426,36.66,297,129
1400000US06037650004,6037650004,2016,335,199,59.400002,152,47
1400000US06037650101,6037650101,2016,574,184,32.060001,124,60
1400000US06037650200,6037650200,2016,2613,1218,46.610001,841,377
1400000US06037650300,6037650300,2016,585,344,58.799999,258,86
1400000US06037650401,6037650401,2016,1256,402,32.009998,295,107
1400000US06037650502,6037650502,2016,1326,203,15.31,136,67
1400000US06037650603,6037650603,2016,3023,716,23.690001,486,230
1400000US06037650701,6037650701,2016,639,160,25.040001,116,44
1400000US06037650702,6037650702,2016,608,61,10.03,46,15
1400000US06037650903,6037650903,2016,2030,713,35.119999,509,204
1400000US06037650904,6037650904,2016,670,425,63.43,328,97
1400000US06037651001,6037651001,2016,712,374,52.529999,286,88
1400000US06037651002,6037651002,2016,786,309,39.310001,218,91
1400000US06037651101,6037651101,2016,916,112,12.23,77,35
1400000US06037651201,6037651201,2016,569,87,15.29,70,17
1400000US06037651221,6037651221,2016,727,162,22.280001,110,52
1400000US06037651222,6037651222,2016,2818,490,17.389999,349,141
1400000US06037651302,6037651302,2016,1348,179,13.28,135,44
1400000US06037651402,6037651402,2016,664,111,16.719999,74,37
1400000US06037670002,6037670002,2016,1442,1158,80.309998,983,175
1400000US06037670003,6037670003,2016,946,590,62.369999,452,138
1400000US06037670101,6037670101,2016,561,474,84.489998,405,69
1400000US06037670202,6037670202,2016,440,14,3.1800001,10,4
1400000US06037670324,6037670324,2016,588,23,3.9100001,22,1
1400000US06037670326,6037670326,2016,487,13,2.6700001,12,1
1400000US06037670328,6037670328,2016,2868,61,2.1300001,47,14
1400000US06037670405,6037670405,2016,926,29,3.1300001,21,8
1400000US06037670413,6037670413,2016,429,10,2.3299999,10,0
1400000US06037670416,6037670416,2016,368,31,8.4200001,26,5
1400000US06037670417,6037670417,2016,2883,110,3.8199999,90,20
1400000US06037670418,6037670418,2016,941,13,1.38,10,3
1400000US06037670500,6037670500,2016,65,9,13.85,9,0
1400000US06037670604,6037670604,2016,397,21,5.29,19,2
1400000US06037670701,6037670701,2016,2315,1414,61.080002,1126,288
1400000US06037670702,6037670702,2016,848,51,6.0100002,41,10
1400000US06037700200,6037700200,2016,1795,823,45.849998,561,262
1400000US06037700400,6037700400,2016,305,147,48.200001,115,32
1400000US06037700501,6037700501,2016,376,56,14.89,46,10
1400000US06037700600,6037700600,2016,639,48,7.5100002,27,21
1400000US06037700700,6037700700,2016,678,40,5.9000001,33,7
1400000US06037700802,6037700802,2016,182,36,19.780001,28,8
1400000US06037700901,6037700901,2016,500,59,11.8,47,12
1400000US06037700902,6037700902,2016,676,43,6.3600001,31,12
1400000US06037701000,6037701000,2016,1556,138,8.8699999,113,25
1400000US06037701304,6037701304,2016,798,97,12.16,74,23
1400000US06037701501,6037701501,2016,1067,195,18.280001,153,42
1400000US06037701601,6037701601,2016,831,48,5.7800002,41,7
1400000US06037701602,6037701602,2016,488,183,37.5,141,42
1400000US06037701801,6037701801,2016,433,209,48.27,170,39
1400000US06037701902,6037701902,2016,2846,813,28.57,655,158
1400000US06037702002,6037702002,2016,557,170,30.52,145,25
1400000US06037702201,6037702201,2016,1602,722,45.07,577,145
1400000US06037702300,6037702300,2016,628,189,30.1,143,46
1400000US06037702400,6037702400,2016,534,155,29.030001,119,36
1400000US06037702600,6037702600,2016,1338,301,22.5,230,71
1400000US06037702700,6037702700,2016,4219,1377,32.639999,1061,316
1400000US06037702801,6037702801,2016,556,298,53.599998,251,47
1400000US06037702803,6037702803,2016,625,441,70.559998,380,61
1400000US06037703002,6037703002,2016,563,252,44.759998,244,8
1400000US06037703100,6037703100,2016,527,398,75.519997,338,60
1400000US06037703200,6037703200,2016,300,262,87.330002,229,33
1400000US06037800101,6037800101,2016,3272,274,8.3699999,210,64
1400000US06037800103,6037800103,2016,286,17,5.9400001,16,1
1400000US06037800202,6037800202,2016,1460,119,8.1499996,94,25
1400000US06037800205,6037800205,2016,589,88,14.94,75,13
1400000US06037800206,6037800206,2016,585,24,4.0999999,22,2
1400000US06037800325,6037800325,2016,432,23,5.3200002,20,3
1400000US06037800334,6037800334,2016,2811,263,9.3599997,208,55
1400000US06037800335,6037800335,2016,25,22,88,22,0
1400000US06037800338,6037800338,2016,2019,133,6.5900002,111,22
1400000US06037800406,6037800406,2016,23,20,86.959999,20,0
1400000US06037800411,6037800411,2016,1272,160,12.58,126,34
1400000US06037800412,6037800412,2016,195,13,6.6700001,13,0
1400000US06037800504,6037800504,2016,279,18,6.4499998,17,1
1400000US06037900102,6037900102,2016,723,681,94.190002,642,39
1400000US06037900103,6037900103,2016,563,532,94.489998,500,32
1400000US06037900104,6037900104,2016,501,442,88.220001,400,42
1400000US06037900301,6037900301,2016,666,574,86.190002,534,40
1400000US06037900501,6037900501,2016,658,612,93.010002,591,21
1400000US06037900504,6037900504,2016,2702,2024,74.910004,1911,113
1400000US06037900505,6037900505,2016,966,848,87.779999,817,31
1400000US06037900508,6037900508,2016,2248,1793,79.760002,1610,183
1400000US06037900510,6037900510,2016,1512,1282,84.790001,1215,67
1400000US06037900602,6037900602,2016,1054,963,91.370003,940,23
1400000US06037900606,6037900606,2016,3106,2537,81.68,2413,124
1400000US06037900607,6037900607,2016,688,649,94.330002,639,10
1400000US06037900609,6037900609,2016,993,866,87.209999,814,52
1400000US06037900610,6037900610,2016,635,556,87.559998,532,24
1400000US06037900701,6037900701,2016,1095,955,87.209999,910,45
1400000US06037900703,6037900703,2016,1820,1538,84.510002,1398,140
1400000US06037900804,6037900804,2016,546,499,91.389999,484,15
1400000US06037900805,6037900805,2016,731,589,80.57,564,25
1400000US06037900807,6037900807,2016,787,696,88.440002,661,35
1400000US06037900901,6037900901,2016,713,321,45.02,264,57
1400000US06037901007,6037901007,2016,762,441,57.869999,390,51
1400000US06037901009,6037901009,2016,1014,729,71.889999,673,56
1400000US06037901010,6037901010,2016,651,481,73.889999,457,24
1400000US06037901011,6037901011,2016,653,456,69.830002,425,31
1400000US06037901012,6037901012,2016,793,529,66.709999,494,35
1400000US06037901013,6037901013,2016,1248,715,57.290001,614,101
1400000US06037901014,6037901014,2016,2182,1330,60.950001,1119,211
1400000US06037901101,6037901101,2016,1065,512,48.080002,436,76
1400000US06037901209,6037901209,2016,380,219,57.630001,185,34
1400000US06037901214,6037901214,2016,1001,487,48.650002,415,72
1400000US06037901215,6037901215,2016,3262,1201,36.82,968,233
1400000US06037901217,6037901217,2016,102,32,31.370001,31,1
1400000US06037901300,6037901300,2016,562,502,89.32,484,18
1400000US06037910002,6037910002,2016,363,295,81.269997,246,49
1400000US06037910210,6037910210,2016,1072,465,43.380001,357,108
1400000US06037910212,6037910212,2016,883,165,18.690001,138,27
1400000US06037910214,6037910214,2016,4168,2680,64.300003,2286,394
1400000US06037910215,6037910215,2016,1388,1086,78.239998,914,172
1400000US06037910217,6037910217,2016,622,336,54.02,267,69
1400000US06037910218,6037910218,2016,602,385,63.950001,353,32
1400000US06037910301,6037910301,2016,787,435,55.27,396,39
1400000US06037910302,6037910302,2016,1637,639,39.029999,532,107
1400000US06037910401,6037910401,2016,1012,748,73.910004,638,110
1400000US06037910404,6037910404,2016,682,611,89.589996,534,77
1400000US06037910405,6037910405,2016,1569,1365,87,1245,120
1400000US06037910504,6037910504,2016,1011,948,93.769997,869,79
1400000US06037910601,6037910601,2016,739,693,93.779999,650,43
1400000US06037910602,6037910602,2016,3611,2892,80.089996,2433,459
1400000US06037910605,6037910605,2016,1496,1333,89.099998,1211,122
1400000US06037910606,6037910606,2016,94,61,64.889999,57,4
1400000US06037910608,6037910608,2016,967,852,88.110001,761,91
1400000US06037910706,6037910706,2016,803,679,84.559998,574,105
1400000US06037910712,6037910712,2016,724,619,85.5,525,94
1400000US06037910714,6037910714,2016,1568,1366,87.120003,1183,183
1400000US06037910715,6037910715,2016,742,682,91.910004,578,104
1400000US06037910716,6037910716,2016,1404,1175,83.690002,1024,151
1400000US06037910717,6037910717,2016,4616,3538,76.650002,2864,674
1400000US06037910718,6037910718,2016,1628,1384,85.010002,1140,244
1400000US06037910720,6037910720,2016,867,767,88.470001,670,97
1400000US06037910804,6037910804,2016,1824,479,26.26,417,62
1400000US06037910807,6037910807,2016,1013,547,54,447,100
1400000US06037910814,6037910814,2016,197,41,20.809999,39,2
1400000US06037910815,6037910815,2016,2039,667,32.709999,587,80
1400000US06037911001,6037911001,2016,770,624,81.040001,570,54
1400000US06037911100,6037911100,2016,2421,2082,86,1848,234
1400000US06037920013,6037920013,2016,679,77,11.34,67,10
1400000US06037920015,6037920015,2016,776,47,6.0599999,43,4
1400000US06037920017,6037920017,2016,1003,192,19.139999,158,34
1400000US06037920020,6037920020,2016,789,210,26.620001,175,35
1400000US06037920029,6037920029,2016,2776,660,23.780001,564,96
1400000US06037920031,6037920031,2016,3142,1239,39.43,1037,202
1400000US06037920034,6037920034,2016,1114,589,52.869999,467,122
1400000US06037920035,6037920035,2016,520,435,83.650002,378,57
1400000US06037920041,6037920041,2016,626,201,32.110001,159,42
1400000US06037920042,6037920042,2016,525,351,66.860001,302,49
1400000US06037920043,6037920043,2016,1497,508,33.93,387,121
1400000US06037920044,6037920044,2016,2297,262,11.41,194,68
1400000US06037920048,6037920048,2016,2289,1165,50.900002,988,177
1400000US06037920049,6037920049,2016,715,104,14.55,92,12
1400000US06037920102,6037920102,2016,702,293,41.740002,250,43
1400000US06037920109,6037920109,2016,733,115,15.69,85,30
1400000US06037920111,6037920111,2016,403,125,31.02,95,30
1400000US06037920112,6037920112,2016,1220,156,12.79,114,42
1400000US06037920115,6037920115,2016,1631,156,9.5600004,124,32
1400000US06037920118,6037920118,2016,2173,652,30,524,128
1400000US06037920119,6037920119,2016,537,72,13.41,58,14
1400000US06037920120,6037920120,2016,617,74,11.99,39,35
1400000US06037920121,6037920121,2016,6788,1160,17.09,931,229
1400000US06037920313,6037920313,2016,1119,742,66.309998,651,91
1400000US06037920314,6037920314,2016,542,170,31.370001,137,33
1400000US06037920322,6037920322,2016,453,184,40.619999,164,20
1400000US06037920326,6037920326,2016,941,139,14.77,94,45
1400000US06037920329,6037920329,2016,1532,810,52.869999,696,114
1400000US06037920330,6037920330,2016,392,31,7.9099998,26,5
1400000US06037920334,6037920334,2016,1314,211,16.059999,164,47
1400000US06037920338,6037920338,2016,783,58,7.4099998,47,11
1400000US06037920339,6037920339,2016,3928,324,8.25,243,81
1400000US06037920340,6037920340,2016,3292,882,26.790001,749,133
1400000US06037920341,6037920341,2016,648,592,91.360001,531,61
1400000US06037920342,6037920342,2016,706,615,87.110001,551,64
1400000US06037930400,6037930400,2016,103,23,22.33,18,5
1400000US06037980004,6037980004,2016,813,806,99.139999,766,40
1400000US06037980013,6037980013,2016,706,310,43.91,198,112
1400000US06037980016,6037980016,2016,252,247,98.019997,232,15
1400000US06037101110,6037101110,2015,1472,904,61.41,748,156
1400000US06037101220,6037101220,2015,308,285,92.529999,274,11
1400000US06037101300,6037101300,2015,366,201,54.919998,154,47
1400000US06037102107,6037102107,2015,222,208,93.690002,205,3
1400000US06037103101,6037103101,2015,981,678,69.110001,578,100
1400000US06037103102,6037103102,2015,802,569,70.949997,469,100
1400000US06037103202,6037103202,2015,165,132,80,121,11
1400000US06037103402,6037103402,2015,427,236,55.27,187,49
1400000US06037104103,6037104103,2015,750,629,83.870003,504,125
1400000US06037104105,6037104105,2015,871,747,85.760002,579,168
1400000US06037104108,6037104108,2015,1494,1373,91.900002,1351,22
1400000US06037104124,6037104124,2015,1207,908,75.230003,697,211
1400000US06037104204,6037104204,2015,677,654,96.599998,647,7
1400000US06037104310,6037104310,2015,2685,2613,97.32,2322,291
1400000US06037104321,6037104321,2015,1483,1185,79.910004,1103,82
1400000US06037104401,6037104401,2015,830,763,91.93,743,20
1400000US06037104500,6037104500,2015,777,715,92.019997,696,19
1400000US06037104821,6037104821,2015,1025,861,84,861,0
1400000US06037104822,6037104822,2015,1389,1305,93.949997,1266,39
1400000US06037106020,6037106020,2015,291,274,94.160004,224,50
1400000US06037106112,6037106112,2015,688,485,70.489998,408,77
1400000US06037106113,6037106113,2015,442,303,68.550003,255,48
1400000US06037106114,6037106114,2015,458,407,88.860001,391,16
1400000US06037106403,6037106403,2015,2423,1766,72.879997,1517,249
1400000US06037106405,6037106405,2015,2671,2354,88.129997,2274,80
1400000US06037106510,6037106510,2015,174,174,100,174,0
1400000US06037106520,6037106520,2015,1262,1064,84.309998,954,110
1400000US06037106603,6037106603,2015,489,103,21.059999,78,25
1400000US06037106604,6037106604,2015,479,406,84.760002,395,11
1400000US06037106641,6037106641,2015,1611,877,54.439999,640,237
1400000US06037106642,6037106642,2015,485,140,28.870001,102,38
1400000US06037106646,6037106646,2015,2510,1456,58.009998,1170,286
1400000US06037106648,6037106648,2015,306,273,89.220001,266,7
1400000US06037107020,6037107020,2015,721,554,76.839996,482,72
1400000US06037108104,6037108104,2015,786,81,10.31,63,18
1400000US06037108202,6037108202,2015,1038,113,10.89,80,33
1400000US06037109200,6037109200,2015,437,284,64.989998,217,67
1400000US06037109300,6037109300,2015,583,402,68.949997,328,74
1400000US06037109500,6037109500,2015,2297,2031,88.419998,1759,272
1400000US06037109601,6037109601,2015,700,480,68.57,377,103
1400000US06037109700,6037109700,2015,1594,1041,65.309998,817,224
1400000US06037109800,6037109800,2015,786,421,53.560001,292,129
1400000US06037111100,6037111100,2015,510,331,64.900002,263,68
1400000US06037111202,6037111202,2015,438,302,68.949997,232,70
1400000US06037111204,6037111204,2015,3145,1059,33.669998,769,290
1400000US06037111206,6037111206,2015,522,182,34.869999,131,51
1400000US06037111302,6037111302,2015,414,235,56.759998,163,72
1400000US06037111303,6037111303,2015,2172,1314,60.5,1015,299
1400000US06037111304,6037111304,2015,4334,2190,50.529999,1382,808
1400000US06037111401,6037111401,2015,422,269,63.740002,221,48
1400000US06037113101,6037113101,2015,517,243,47,213,30
1400000US06037113212,6037113212,2015,358,196,54.75,158,38
1400000US06037113232,6037113232,2015,442,370,83.709999,357,13
1400000US06037113303,6037113303,2015,677,350,51.700001,291,59
1400000US06037113322,6037113322,2015,445,150,33.709999,114,36
1400000US06037113323,6037113323,2015,1492,802,53.75,652,150
1400000US06037113324,6037113324,2015,2212,1299,58.73,1041,258
1400000US06037113423,6037113423,2015,152,94,61.84,75,19
1400000US06037113428,6037113428,2015,830,727,87.589996,704,23
1400000US06037115101,6037115101,2015,2797,1342,47.98,1075,267
1400000US06037115103,6037115103,2015,1059,674,63.639999,551,123
1400000US06037115202,6037115202,2015,583,343,58.830002,280,63
1400000US06037115301,6037115301,2015,534,195,36.52,152,43
1400000US06037115302,6037115302,2015,467,401,85.870003,397,4
1400000US06037115401,6037115401,2015,837,776,92.709999,750,26
1400000US06037115403,6037115403,2015,291,222,76.290001,191,31
1400000US06037117101,6037117101,2015,3348,3091,92.32,2991,100
1400000US06037117102,6037117102,2015,496,381,76.809998,338,43
1400000US06037117202,6037117202,2015,2915,2207,75.709999,2084,123
1400000US06037117302,6037117302,2015,647,587,90.730003,570,17
1400000US06037117303,6037117303,2015,263,74,28.139999,48,26
1400000US06037117407,6037117407,2015,586,537,91.639999,513,24
1400000US06037117510,6037117510,2015,482,414,85.889999,355,59
1400000US06037117520,6037117520,2015,717,658,91.769997,622,36
1400000US06037117530,6037117530,2015,842,781,92.760002,771,10
1400000US06037119003,6037119003,2015,759,711,93.68,694,17
1400000US06037119004,6037119004,2015,544,460,84.559998,435,25
1400000US06037119201,6037119201,2015,2042,1871,91.629997,1830,41
1400000US06037119342,6037119342,2015,759,636,83.790001,567,69
1400000US06037119802,6037119802,2015,985,817,82.940002,791,26
1400000US06037119900,6037119900,2015,651,598,91.860001,587,11
1400000US06037120010,6037120010,2015,1282,1215,94.769997,1199,16
1400000US06037120020,6037120020,2015,805,756,93.910004,750,6
1400000US06037120030,6037120030,2015,1398,986,70.529999,909,77
1400000US06037120107,6037120107,2015,543,510,93.919998,507,3
1400000US06037120108,6037120108,2015,1148,1049,91.379997,1039,10
1400000US06037120300,6037120300,2015,439,408,92.940002,404,4
1400000US06037120400,6037120400,2015,551,486,88.199997,478,8
1400000US06037121010,6037121010,2015,4509,4013,89,3959,54
1400000US06037121020,6037121020,2015,735,651,88.57,640,11
1400000US06037121102,6037121102,2015,324,232,71.599998,190,42
1400000US06037121210,6037121210,2015,363,316,87.050003,260,56
1400000US06037121222,6037121222,2015,1538,1254,81.529999,1201,53
1400000US06037121600,6037121600,2015,110,79,71.82,68,11
1400000US06037121801,6037121801,2015,578,544,94.120003,542,2
1400000US06037121900,6037121900,2015,458,403,87.989998,393,10
1400000US06037122000,6037122000,2015,586,483,82.419998,473,10
1400000US06037122122,6037122122,2015,703,650,92.459999,647,3
1400000US06037122200,6037122200,2015,427,394,92.269997,390,4
1400000US06037122420,6037122420,2015,700,646,92.290001,591,55
1400000US06037123010,6037123010,2015,1476,1352,91.599998,1311,41
1400000US06037123301,6037123301,2015,599,546,91.150002,538,8
1400000US06037123303,6037123303,2015,767,713,92.959999,700,13
1400000US06037123420,6037123420,2015,1644,1519,92.400002,1476,43
1400000US06037123510,6037123510,2015,806,717,88.959999,666,51
1400000US06037123601,6037123601,2015,2050,1292,63.02,1161,131
1400000US06037123602,6037123602,2015,684,639,93.419998,622,17
1400000US06037123700,6037123700,2015,679,512,75.410004,418,94
1400000US06037123901,6037123901,2015,2063,1937,93.889999,1887,50
1400000US06037124102,6037124102,2015,732,660,90.160004,619,41
1400000US06037124201,6037124201,2015,939,876,93.290001,843,33
1400000US06037124300,6037124300,2015,438,382,87.209999,334,48
1400000US06037124600,6037124600,2015,2069,748,36.150002,603,145
1400000US06037124700,6037124700,2015,603,171,28.360001,142,29
1400000US06037124902,6037124902,2015,350,261,74.57,253,8
1400000US06037125101,6037125101,2015,2691,1824,67.779999,1539,285
1400000US06037125102,6037125102,2015,657,131,19.940001,110,21
1400000US06037125310,6037125310,2015,640,470,73.440002,450,20
1400000US06037125322,6037125322,2015,465,413,88.82,405,8
1400000US06037125600,6037125600,2015,450,307,68.220001,265,42
1400000US06037127210,6037127210,2015,2674,2423,90.610001,2339,84
1400000US06037127400,6037127400,2015,558,540,96.769997,528,12
1400000US06037127603,6037127603,2015,875,802,91.660004,794,8
1400000US06037127803,6037127803,2015,177,88,49.720001,70,18
1400000US06037127805,6037127805,2015,550,491,89.269997,483,8
1400000US06037127806,6037127806,2015,2627,1940,73.849998,1849,91
1400000US06037127910,6037127910,2015,1408,811,57.599998,652,159
1400000US06037127920,6037127920,2015,736,674,91.580002,669,5
1400000US06037128102,6037128102,2015,970,741,76.389999,681,60
1400000US06037128302,6037128302,2015,1093,900,82.339996,882,18
1400000US06037128602,6037128602,2015,490,264,53.880001,234,30
1400000US06037128802,6037128802,2015,2208,1519,68.800003,1286,233
1400000US06037128910,6037128910,2015,238,69,28.99,47,22
1400000US06037131022,6037131022,2015,516,453,87.790001,448,5
1400000US06037131023,6037131023,2015,386,351,90.93,343,8
1400000US06037131100,6037131100,2015,457,330,72.209999,276,54
1400000US06037131200,6037131200,2015,582,351,60.310001,299,52
1400000US06037131300,6037131300,2015,531,455,85.690002,439,16
1400000US06037131600,6037131600,2015,3539,2202,62.220001,1847,355
1400000US06037131701,6037131701,2015,81,61,75.309998,49,12
1400000US06037131801,6037131801,2015,438,377,86.07,368,9
1400000US06037131900,6037131900,2015,429,365,85.080002,353,12
1400000US06037132001,6037132001,2015,386,264,68.389999,220,44
1400000US06037132002,6037132002,2015,6150,4706,76.519997,3906,800
1400000US06037132301,6037132301,2015,412,369,89.559998,362,7
1400000US06037132501,6037132501,2015,46,23,50,18,5
1400000US06037132700,6037132700,2015,2214,1530,69.110001,1361,169
1400000US06037133000,6037133000,2015,539,401,74.400002,352,49
1400000US06037133101,6037133101,2015,397,288,72.540001,251,37
1400000US06037133102,6037133102,2015,2076,1083,52.169998,785,298
1400000US06037134001,6037134001,2015,804,768,95.519997,756,12
1400000US06037134002,6037134002,2015,392,231,58.93,183,48
1400000US06037134101,6037134101,2015,472,430,91.099998,412,18
1400000US06037134103,6037134103,2015,572,485,84.790001,448,37
1400000US06037134104,6037134104,2015,363,335,92.290001,308,27
1400000US06037134302,6037134302,2015,400,293,73.25,237,56
1400000US06037134303,6037134303,2015,774,695,89.790001,682,13
1400000US06037134304,6037134304,2015,713,617,86.540001,598,19
1400000US06037134421,6037134421,2015,618,90,14.56,76,14
1400000US06037134422,6037134422,2015,237,157,66.239998,128,29
1400000US06037134423,6037134423,2015,397,122,30.73,94,28
1400000US06037134520,6037134520,2015,1554,1107,71.239998,989,118
1400000US06037134522,6037134522,2015,589,532,90.32,499,33
1400000US06037134720,6037134720,2015,1731,1537,88.790001,1464,73
1400000US06037134801,6037134801,2015,482,428,88.800003,416,12
1400000US06037135102,6037135102,2015,463,184,39.740002,151,33
1400000US06037135202,6037135202,2015,812,89,10.96,66,23
1400000US06037135204,6037135204,2015,719,144,20.030001,103,41
1400000US06037137000,6037137000,2015,3775,685,18.15,510,175
1400000US06037137104,6037137104,2015,1039,649,62.459999,537,112
1400000US06037137203,6037137203,2015,936,300,32.049999,245,55
1400000US06037137301,6037137301,2015,496,132,26.610001,113,19
1400000US06037137302,6037137302,2015,1963,486,24.76,385,101
1400000US06037137401,6037137401,2015,699,73,10.44,57,16
1400000US06037137402,6037137402,2015,419,63,15.04,49,14
1400000US06037137501,6037137501,2015,3036,1531,50.43,1246,285
1400000US06037139001,6037139001,2015,576,148,25.690001,107,41
1400000US06037139200,6037139200,2015,406,253,62.32,207,46
1400000US06037139301,6037139301,2015,786,511,65.010002,432,79
1400000US06037139402,6037139402,2015,3155,1091,34.580002,850,241
1400000US06037139502,6037139502,2015,570,226,39.650002,180,46
1400000US06037139600,6037139600,2015,553,113,20.43,81,32
1400000US06037139701,6037139701,2015,554,13,2.3499999,7,6
1400000US06037141101,6037141101,2015,692,144,20.809999,123,21
1400000US06037141304,6037141304,2015,812,173,21.309999,136,37
1400000US06037141400,6037141400,2015,548,77,14.05,56,21
1400000US06037143200,6037143200,2015,872,491,56.310001,410,81
1400000US06037143302,6037143302,2015,1665,831,49.91,729,102
1400000US06037143700,6037143700,2015,215,52,24.190001,47,5
1400000US06037143801,6037143801,2015,934,39,4.1799998,35,4
1400000US06037181000,6037181000,2015,1234,937,75.93,768,169
1400000US06037181400,6037181400,2015,771,407,52.790001,317,90
1400000US06037181500,6037181500,2015,999,581,58.16,505,76
1400000US06037181600,6037181600,2015,2406,1274,52.950001,985,289
1400000US06037183101,6037183101,2015,1263,1169,92.559998,1126,43
1400000US06037183104,6037183104,2015,212,165,77.830002,146,19
1400000US06037183220,6037183220,2015,295,232,78.639999,226,6
1400000US06037183221,6037183221,2015,73,73,100,73,0
1400000US06037183401,6037183401,2015,500,413,82.599998,392,21
1400000US06037183402,6037183402,2015,343,289,84.260002,284,5
1400000US06037183510,6037183510,2015,1411,1014,71.860001,916,98
1400000US06037183520,6037183520,2015,438,398,90.870003,377,21
1400000US06037183702,6037183702,2015,335,199,59.400002,174,25
1400000US06037183810,6037183810,2015,231,182,78.790001,172,10
1400000US06037185101,6037185101,2015,527,435,82.540001,418,17
1400000US06037185102,6037185102,2015,589,480,81.489998,472,8
1400000US06037185204,6037185204,2015,398,52,13.07,44,8
1400000US06037185310,6037185310,2015,1083,985,90.949997,928,57
1400000US06037186100,6037186100,2015,504,255,50.599998,202,53
1400000US06037186302,6037186302,2015,200,178,89,140,38
1400000US06037186401,6037186401,2015,1956,1723,88.089996,1598,125
1400000US06037186404,6037186404,2015,441,382,86.620003,357,25
1400000US06037187101,6037187101,2015,332,248,74.699997,214,34
1400000US06037187102,6037187102,2015,1365,835,61.169998,625,210
1400000US06037187300,6037187300,2015,424,355,83.730003,336,19
1400000US06037188201,6037188201,2015,457,45,9.8500004,32,13
1400000US06037188300,6037188300,2015,335,214,63.880001,186,28
1400000US06037189201,6037189201,2015,460,315,68.480003,281,34
1400000US06037189501,6037189501,2015,307,215,70.029999,194,21
1400000US06037189905,6037189905,2015,445,244,54.830002,204,40
1400000US06037190102,6037190102,2015,1501,1170,77.949997,986,184
1400000US06037190510,6037190510,2015,578,460,79.580002,427,33
1400000US06037190701,6037190701,2015,191,159,83.25,157,2
1400000US06037190901,6037190901,2015,1223,789,64.510002,737,52
1400000US06037190902,6037190902,2015,1077,1001,92.940002,966,35
1400000US06037191120,6037191120,2015,494,441,89.269997,411,30
1400000US06037191204,6037191204,2015,651,585,89.860001,574,11
1400000US06037191301,6037191301,2015,202,186,92.080002,177,9
1400000US06037191410,6037191410,2015,438,351,80.139999,334,17
1400000US06037191720,6037191720,2015,915,897,98.029999,847,50
1400000US06037191810,6037191810,2015,514,475,92.410004,467,8
1400000US06037191901,6037191901,2015,834,728,87.290001,700,28
1400000US06037192001,6037192001,2015,329,170,51.669998,137,33
1400000US06037192002,6037192002,2015,2054,1421,69.18,1218,203
1400000US06037192410,6037192410,2015,263,217,82.510002,210,7
1400000US06037192520,6037192520,2015,471,422,89.599998,410,12
1400000US06037192620,6037192620,2015,685,648,94.599998,638,10
1400000US06037192700,6037192700,2015,556,511,91.910004,501,10
1400000US06037194300,6037194300,2015,536,32,5.9699998,23,9
1400000US06037195201,6037195201,2015,2887,1757,60.860001,1424,333
1400000US06037195300,6037195300,2015,1811,1030,56.869999,897,133
1400000US06037195400,6037195400,2015,320,145,45.310001,129,16
1400000US06037195500,6037195500,2015,289,232,80.279999,209,23
1400000US06037195710,6037195710,2015,1062,974,91.709999,884,90
1400000US06037197200,6037197200,2015,319,251,78.68,222,29
1400000US06037197300,6037197300,2015,239,168,70.290001,156,12
1400000US06037197410,6037197410,2015,124,108,87.099998,102,6
1400000US06037197420,6037197420,2015,911,828,90.889999,754,74
1400000US06037199001,6037199001,2015,137,86,62.77,76,10
1400000US06037199002,6037199002,2015,388,374,96.389999,366,8
1400000US06037199201,6037199201,2015,277,224,80.870003,184,40
1400000US06037199202,6037199202,2015,1735,1176,67.779999,1064,112
1400000US06037199300,6037199300,2015,748,591,79.010002,551,40
1400000US06037199400,6037199400,2015,266,250,93.980003,247,3
1400000US06037199700,6037199700,2015,1588,1484,93.449997,1301,183
1400000US06037199801,6037199801,2015,536,481,89.739998,438,43
1400000US06037199802,6037199802,2015,683,611,89.459999,594,17
1400000US06037201110,6037201110,2015,449,211,46.990002,127,84
1400000US06037201120,6037201120,2015,250,194,77.599998,193,1
1400000US06037201200,6037201200,2015,422,383,90.760002,374,9
1400000US06037201301,6037201301,2015,446,366,82.059998,338,28
1400000US06037201401,6037201401,2015,2154,1858,86.260002,1717,141
1400000US06037201402,6037201402,2015,1996,1476,73.949997,1347,129
1400000US06037201501,6037201501,2015,319,295,92.480003,289,6
1400000US06037201602,6037201602,2015,432,390,90.279999,382,8
1400000US06037201700,6037201700,2015,641,30,4.6799998,23,7
1400000US06037203100,6037203100,2015,487,464,95.279999,453,11
1400000US06037203200,6037203200,2015,843,724,85.879997,682,42
1400000US06037203300,6037203300,2015,2066,1878,90.900002,1809,69
1400000US06037203500,6037203500,2015,242,174,71.900002,168,6
1400000US06037203601,6037203601,2015,995,918,92.260002,912,6
1400000US06037203800,6037203800,2015,679,607,89.400002,602,5
1400000US06037204300,6037204300,2015,2869,2349,81.879997,2213,136
1400000US06037204410,6037204410,2015,403,380,94.290001,377,3
1400000US06037204420,6037204420,2015,880,792,90,735,57
1400000US06037204700,6037204700,2015,2369,2093,88.349998,1944,149
1400000US06037204810,6037204810,2015,1522,1351,88.760002,1260,91
1400000US06037204820,6037204820,2015,606,574,94.720001,507,67
1400000US06037204910,6037204910,2015,1593,1482,93.029999,1452,30
1400000US06037205110,6037205110,2015,1062,970,91.339996,887,83
1400000US06037205120,6037205120,2015,145,138,95.169998,133,5
1400000US06037206010,6037206010,2015,362,280,77.349998,239,41
1400000US06037206050,6037206050,2015,98,98,100,98,0
1400000US06037206051,6037206051,2015,583,525,90.050003,475,50
1400000US06037206054,6037206054,2015,1246,1102,88.440002,1084,18
1400000US06037207101,6037207101,2015,1598,993,62.139999,876,117
1400000US06037207103,6037207103,2015,638,533,83.540001,516,17
1400000US06037207400,6037207400,2015,398,376,94.470001,370,6
1400000US06037207712,6037207712,2015,81,66,81.480003,59,7
1400000US06037208001,6037208001,2015,3204,2774,86.580002,2601,173
1400000US06037208002,6037208002,2015,653,531,81.32,492,39
1400000US06037208302,6037208302,2015,1861,1554,83.5,1508,46
1400000US06037208401,6037208401,2015,1112,1003,90.199997,999,4
1400000US06037208501,6037208501,2015,546,349,63.919998,314,35
1400000US06037208610,6037208610,2015,515,486,94.370003,451,35
1400000US06037208710,6037208710,2015,94,80,85.110001,79,1
1400000US06037208801,6037208801,2015,519,484,93.260002,482,2
1400000US06037208802,6037208802,2015,497,443,89.129997,441,2
1400000US06037208902,6037208902,2015,1329,1275,95.940002,1272,3
1400000US06037209103,6037209103,2015,874,835,95.540001,820,15
1400000US06037209104,6037209104,2015,314,313,99.68,309,4
1400000US06037209106,6037209106,2015,1148,1077,93.82,1073,4
1400000US06037209202,6037209202,2015,2291,1643,71.720001,1634,9
1400000US06037210010,6037210010,2015,855,832,97.309998,828,4
1400000US06037211000,6037211000,2015,1849,1292,69.879997,1062,230
1400000US06037211121,6037211121,2015,1208,1138,94.209999,1088,50
1400000US06037211122,6037211122,2015,2626,2160,82.25,1994,166
1400000US06037211123,6037211123,2015,928,827,89.120003,783,44
1400000US06037211124,6037211124,2015,475,454,95.580002,408,46
1400000US06037211202,6037211202,2015,747,685,91.699997,675,10
1400000US06037211410,6037211410,2015,697,445,63.849998,388,57
1400000US06037211420,6037211420,2015,555,396,71.349998,341,55
1400000US06037212202,6037212202,2015,785,752,95.800003,749,3
1400000US06037212204,6037212204,2015,524,483,92.18,399,84
1400000US06037212303,6037212303,2015,169,166,98.220001,148,18
1400000US06037212304,6037212304,2015,3912,3369,86.120003,3326,43
1400000US06037212610,6037212610,2015,1315,968,73.610001,815,153
1400000US06037212800,6037212800,2015,1669,1296,77.650002,1211,85
1400000US06037213201,6037213201,2015,688,615,89.389999,576,39
1400000US06037213202,6037213202,2015,792,744,93.940002,739,5
1400000US06037213310,6037213310,2015,239,218,91.209999,218,0
1400000US06037213320,6037213320,2015,1223,1189,97.220001,1159,30
1400000US06037213402,6037213402,2015,716,694,96.93,691,3
1400000US06037214100,6037214100,2015,707,129,18.25,106,23
1400000US06037214501,6037214501,2015,817,136,16.65,102,34
1400000US06037216201,6037216201,2015,212,133,62.740002,125,8
1400000US06037216301,6037216301,2015,324,207,63.889999,179,28
1400000US06037216700,6037216700,2015,2015,1121,55.630001,857,264
1400000US06037217101,6037217101,2015,429,315,73.43,284,31
1400000US06037218110,6037218110,2015,1972,1433,72.669998,1333,100
1400000US06037218210,6037218210,2015,623,480,77.050003,449,31
1400000US06037218300,6037218300,2015,305,237,77.699997,192,45
1400000US06037218800,6037218800,2015,637,539,84.620003,505,34
1400000US06037218900,6037218900,2015,1003,772,76.970001,696,76
1400000US06037219010,6037219010,2015,641,570,88.919998,562,8
1400000US06037219300,6037219300,2015,545,475,87.160004,433,42
1400000US06037219700,6037219700,2015,1126,742,65.900002,681,61
1400000US06037219800,6037219800,2015,632,508,80.379997,497,11
1400000US06037219902,6037219902,2015,925,893,96.540001,862,31
1400000US06037220000,6037220000,2015,409,253,61.860001,240,13
1400000US06037220100,6037220100,2015,585,454,77.610001,408,46
1400000US06037221120,6037221120,2015,1074,954,88.830002,953,1
1400000US06037221304,6037221304,2015,922,781,84.709999,751,30
1400000US06037221401,6037221401,2015,1009,948,93.949997,886,62
1400000US06037221602,6037221602,2015,2469,2247,91.010002,2219,28
1400000US06037221810,6037221810,2015,708,588,83.050003,582,6
1400000US06037221900,6037221900,2015,432,343,79.400002,322,21
1400000US06037222002,6037222002,2015,697,625,89.669998,605,20
1400000US06037222500,6037222500,2015,1924,1692,87.940002,1574,118
1400000US06037222600,6037222600,2015,684,606,88.599998,601,5
1400000US06037224010,6037224010,2015,36,35,97.220001,35,0
1400000US06037224020,6037224020,2015,1890,1763,93.279999,1682,81
1400000US06037224320,6037224320,2015,443,424,95.709999,381,43
1400000US06037224410,6037224410,2015,2016,1914,94.940002,1775,139
1400000US06037224420,6037224420,2015,853,752,88.160004,713,39
1400000US06037224600,6037224600,2015,1374,1292,94.029999,1286,6
1400000US06037224702,6037224702,2015,1078,850,78.849998,732,118
1400000US06037226001,6037226001,2015,3049,2754,90.32,2710,44
1400000US06037226002,6037226002,2015,852,714,83.800003,670,44
1400000US06037226702,6037226702,2015,1413,1258,89.029999,1221,37
1400000US06037227020,6037227020,2015,1494,1406,94.110001,1304,102
1400000US06037228100,6037228100,2015,1761,1732,98.349998,1656,76
1400000US06037228210,6037228210,2015,1849,1590,85.989998,1518,72
1400000US06037228310,6037228310,2015,1375,1221,88.800003,1192,29
1400000US06037228320,6037228320,2015,675,646,95.699997,641,5
1400000US06037228410,6037228410,2015,585,543,92.82,540,3
1400000US06037228420,6037228420,2015,1176,1134,96.43,1055,79
1400000US06037228500,6037228500,2015,633,617,97.470001,571,46
1400000US06037228600,6037228600,2015,2143,1988,92.769997,1959,29
1400000US06037228710,6037228710,2015,1205,1160,96.269997,1154,6
1400000US06037228720,6037228720,2015,914,835,91.360001,829,6
1400000US06037228800,6037228800,2015,316,296,93.669998,296,0
1400000US06037229200,6037229200,2015,850,770,90.589996,766,4
1400000US06037229300,6037229300,2015,278,278,100,254,24
1400000US06037229410,6037229410,2015,3136,2632,83.93,2538,94
1400000US06037229420,6037229420,2015,1944,1811,93.160004,1755,56
1400000US06037231100,6037231100,2015,1752,1709,97.550003,1631,78
1400000US06037231220,6037231220,2015,992,822,82.860001,741,81
1400000US06037231302,6037231302,2015,465,401,86.239998,398,3
1400000US06037231500,6037231500,2015,307,287,93.489998,250,37
1400000US06037231603,6037231603,2015,1434,1124,78.379997,1120,4
1400000US06037231710,6037231710,2015,583,548,94,545,3
1400000US06037231720,6037231720,2015,232,229,98.709999,198,31
1400000US06037231800,6037231800,2015,746,722,96.779999,721,1
1400000US06037232110,6037232110,2015,1588,1444,90.93,1422,22
1400000US06037232200,6037232200,2015,1283,1195,93.139999,1156,39
1400000US06037232300,6037232300,2015,250,227,90.800003,209,18
1400000US06037232401,6037232401,2015,1116,863,77.330002,839,24
1400000US06037232500,6037232500,2015,508,438,86.220001,430,8
1400000US06037234001,6037234001,2015,608,479,78.779999,467,12
1400000US06037234002,6037234002,2015,424,414,97.639999,395,19
1400000US06037234301,6037234301,2015,836,682,81.580002,670,12
1400000US06037234501,6037234501,2015,1368,1040,76.019997,985,55
1400000US06037234502,6037234502,2015,816,790,96.809998,700,90
1400000US06037234600,6037234600,2015,2582,2036,78.849998,1789,247
1400000US06037234700,6037234700,2015,364,300,82.419998,283,17
1400000US06037234901,6037234901,2015,608,537,88.32,536,1
1400000US06037235201,6037235201,2015,1049,954,90.940002,892,62
1400000US06037236203,6037236203,2015,814,772,94.839996,711,61
1400000US06037236204,6037236204,2015,696,570,81.900002,565,5
1400000US06037236400,6037236400,2015,234,191,81.620003,176,15
1400000US06037237101,6037237101,2015,3599,2893,80.379997,2803,90
1400000US06037237102,6037237102,2015,584,548,93.839996,540,8
1400000US06037237300,6037237300,2015,705,464,65.82,421,43
1400000US06037237500,6037237500,2015,628,555,88.379997,548,7
1400000US06037237600,6037237600,2015,781,673,86.169998,654,19
1400000US06037237800,6037237800,2015,524,481,91.790001,449,32
1400000US06037237900,6037237900,2015,549,450,81.970001,437,13
1400000US06037238000,6037238000,2015,631,593,93.980003,562,31
1400000US06037238200,6037238200,2015,469,422,89.980003,356,66
1400000US06037238320,6037238320,2015,1152,986,85.589996,845,141
1400000US06037238400,6037238400,2015,429,302,70.400002,301,1
1400000US06037239201,6037239201,2015,990,942,95.150002,903,39
1400000US06037239320,6037239320,2015,1242,1197,96.379997,1192,5
1400000US06037239330,6037239330,2015,899,752,83.650002,750,2
1400000US06037239502,6037239502,2015,3673,3218,87.610001,3168,50
1400000US06037239601,6037239601,2015,989,921,93.120003,914,7
1400000US06037239802,6037239802,2015,1030,744,72.230003,727,17
1400000US06037240010,6037240010,2015,1592,1293,81.220001,1242,51
1400000US06037240200,6037240200,2015,860,794,92.330002,790,4
1400000US06037240301,6037240301,2015,790,749,94.809998,722,27
1400000US06037240302,6037240302,2015,196,194,98.980003,194,0
1400000US06037240401,6037240401,2015,1749,1608,91.940002,1595,13
1400000US06037240500,6037240500,2015,1411,1365,96.739998,1251,114
1400000US06037240600,6037240600,2015,1093,1028,94.050003,1024,4
1400000US06037240700,6037240700,2015,645,611,94.730003,608,3
1400000US06037240902,6037240902,2015,2462,2328,94.559998,2220,108
1400000US06037241001,6037241001,2015,926,890,96.110001,853,37
1400000US06037241110,6037241110,2015,886,784,88.489998,764,20
1400000US06037241120,6037241120,2015,617,540,87.519997,539,1
1400000US06037241202,6037241202,2015,633,584,92.260002,569,15
1400000US06037241400,6037241400,2015,597,583,97.650002,580,3
1400000US06037242000,6037242000,2015,477,450,94.339996,444,6
1400000US06037242100,6037242100,2015,1016,754,74.209999,737,17
1400000US06037242201,6037242201,2015,878,823,93.739998,816,7
1400000US06037242202,6037242202,2015,886,845,95.370003,828,17
1400000US06037242300,6037242300,2015,842,803,95.370003,800,3
1400000US06037242600,6037242600,2015,434,417,96.080002,416,1
1400000US06037242700,6037242700,2015,1738,1548,89.07,1533,15
1400000US06037243001,6037243001,2015,506,499,98.620003,475,24
1400000US06037243002,6037243002,2015,442,393,88.910004,379,14
1400000US06037243100,6037243100,2015,643,620,96.419998,617,3
1400000US06037262200,6037262200,2015,922,148,16.049999,111,37
1400000US06037262303,6037262303,2015,531,28,5.27,27,1
1400000US06037262604,6037262604,2015,511,33,6.46,31,2
1400000US06037262704,6037262704,2015,2857,878,30.73,712,166
1400000US06037262706,6037262706,2015,519,29,5.5900002,26,3
1400000US06037262802,6037262802,2015,2475,501,20.24,426,75
1400000US06037264305,6037264305,2015,985,715,72.589996,616,99
1400000US06037265100,6037265100,2015,657,30,4.5700002,21,9
1400000US06037265601,6037265601,2015,991,322,32.490002,270,52
1400000US06037267202,6037267202,2015,861,58,6.7399998,37,21
1400000US06037267300,6037267300,2015,322,234,72.669998,201,33
1400000US06037267404,6037267404,2015,1712,1242,72.550003,1010,232
1400000US06037267406,6037267406,2015,214,145,67.760002,133,12
1400000US06037267600,6037267600,2015,1099,217,19.75,82,135
1400000US06037269000,6037269000,2015,573,148,25.83,118,30
1400000US06037269100,6037269100,2015,367,77,20.98,65,12
1400000US06037269300,6037269300,2015,501,35,6.9899998,26,9
1400000US06037269700,6037269700,2015,3380,2010,59.470001,1710,300
1400000US06037269907,6037269907,2015,417,291,69.779999,253,38
1400000US06037271200,6037271200,2015,200,55,27.5,40,15
1400000US06037271300,6037271300,2015,904,684,75.660004,617,67
1400000US06037271400,6037271400,2015,340,135,39.709999,116,19
1400000US06037271500,6037271500,2015,576,77,13.37,58,19
1400000US06037271702,6037271702,2015,610,118,19.34,102,16
1400000US06037271703,6037271703,2015,1486,782,52.619999,640,142
1400000US06037271801,6037271801,2015,324,228,70.370003,205,23
1400000US06037272100,6037272100,2015,957,594,62.07,521,73
1400000US06037272302,6037272302,2015,39,20,51.279999,16,4
1400000US06037273200,6037273200,2015,1083,605,55.860001,478,127
1400000US06037273403,6037273403,2015,320,272,85,261,11
1400000US06037273800,6037273800,2015,2591,1328,51.25,1155,173
1400000US06037274202,6037274202,2015,388,255,65.720001,235,20
1400000US06037275200,6037275200,2015,527,512,97.150002,471,41
1400000US06037275311,6037275311,2015,1536,760,49.48,685,75
1400000US06037275400,6037275400,2015,306,162,52.939999,141,21
1400000US06037275500,6037275500,2015,712,605,84.970001,578,27
1400000US06037275603,6037275603,2015,240,125,52.080002,103,22
1400000US06037275604,6037275604,2015,397,82,20.65,60,22
1400000US06037275605,6037275605,2015,403,300,74.440002,235,65
1400000US06037276000,6037276000,2015,360,219,60.830002,179,40
1400000US06037276400,6037276400,2015,375,97,25.870001,76,21
1400000US06037276605,6037276605,2015,501,243,48.5,204,39
1400000US06037276607,6037276607,2015,389,231,59.380001,196,35
1400000US06037276608,6037276608,2015,1325,621,46.869999,533,88
1400000US06037277000,6037277000,2015,1411,691,48.970001,575,116
1400000US06037277100,6037277100,2015,405,60,14.81,39,21
1400000US06037291120,6037291120,2015,796,724,90.949997,712,12
1400000US06037291210,6037291210,2015,532,441,82.889999,407,34
1400000US06037291220,6037291220,2015,342,334,97.660004,261,73
1400000US06037291300,6037291300,2015,1026,842,82.07,809,33
1400000US06037293204,6037293204,2015,533,413,77.489998,366,47
1400000US06037293302,6037293302,2015,3375,2056,60.919998,1765,291
1400000US06037293304,6037293304,2015,619,524,84.650002,510,14
1400000US06037294110,6037294110,2015,3190,2432,76.239998,2137,295
1400000US06037294200,6037294200,2015,1479,1235,83.5,1131,104
1400000US06037294302,6037294302,2015,432,264,61.110001,207,57
1400000US06037294410,6037294410,2015,414,378,91.300003,366,12
1400000US06037294510,6037294510,2015,819,771,94.139999,754,17
1400000US06037294520,6037294520,2015,516,421,81.589996,386,35
1400000US06037294610,6037294610,2015,1202,1122,93.339996,1073,49
1400000US06037294620,6037294620,2015,821,663,80.760002,601,62
1400000US06037294830,6037294830,2015,670,577,86.120003,563,14
1400000US06037294900,6037294900,2015,649,619,95.379997,605,14
1400000US06037295103,6037295103,2015,757,362,47.82,275,87
1400000US06037296220,6037296220,2015,933,507,54.34,393,114
1400000US06037296300,6037296300,2015,723,373,51.59,294,79
1400000US06037296401,6037296401,2015,628,360,57.32,280,80
1400000US06037296500,6037296500,2015,1023,945,92.379997,925,20
1400000US06037296600,6037296600,2015,408,378,92.650002,367,11
1400000US06037296901,6037296901,2015,4070,2368,58.18,2035,333
1400000US06037297110,6037297110,2015,90,80,88.889999,75,5
1400000US06037297120,6037297120,2015,551,461,83.669998,451,10
1400000US06037297202,6037297202,2015,589,464,78.779999,377,87
1400000US06037297400,6037297400,2015,477,185,38.779999,139,46
1400000US06037297501,6037297501,2015,403,98,24.32,65,33
1400000US06037297601,6037297601,2015,66,53,80.300003,50,3
1400000US06037297602,6037297602,2015,327,198,60.549999,163,35
1400000US06037300200,6037300200,2015,2518,384,15.25,268,116
1400000US06037300301,6037300301,2015,2025,753,37.189999,561,192
1400000US06037300400,6037300400,2015,474,112,23.629999,75,37
1400000US06037300501,6037300501,2015,3364,658,19.559999,477,181
1400000US06037300602,6037300602,2015,690,156,22.610001,115,41
1400000US06037300800,6037300800,2015,816,176,21.57,128,48
1400000US06037300902,6037300902,2015,542,171,31.549999,134,37
1400000US06037301000,6037301000,2015,1238,728,58.799999,585,143
1400000US06037301206,6037301206,2015,3843,2289,59.560001,1835,454
1400000US06037301400,6037301400,2015,724,388,53.59,322,66
1400000US06037301502,6037301502,2015,627,485,77.349998,388,97
1400000US06037301602,6037301602,2015,634,159,25.08,119,40
1400000US06037301801,6037301801,2015,577,453,78.510002,368,85
1400000US06037301902,6037301902,2015,933,574,61.52,468,106
1400000US06037302002,6037302002,2015,183,128,69.949997,111,17
1400000US06037302004,6037302004,2015,506,438,86.559998,374,64
1400000US06037302104,6037302104,2015,2522,1719,68.160004,1429,290
1400000US06037302302,6037302302,2015,866,591,68.239998,488,103
1400000US06037302504,6037302504,2015,2293,1935,84.389999,1701,234
1400000US06037302505,6037302505,2015,408,355,87.010002,314,41
1400000US06037310201,6037310201,2015,596,209,35.07,155,54
1400000US06037310300,6037310300,2015,2141,691,32.27,496,195
1400000US06037310601,6037310601,2015,455,257,56.48,199,58
1400000US06037310602,6037310602,2015,2551,955,37.439999,755,200
1400000US06037310703,6037310703,2015,720,308,42.779999,243,65
1400000US06037310705,6037310705,2015,24,19,79.169998,15,4
1400000US06037310800,6037310800,2015,2994,996,33.27,728,268
1400000US06037310900,6037310900,2015,1444,745,51.59,610,135
1400000US06037311000,6037311000,2015,1035,430,41.549999,310,120
1400000US06037311100,6037311100,2015,1103,430,38.98,311,119
1400000US06037311500,6037311500,2015,1196,199,16.639999,144,55
1400000US06037311700,6037311700,2015,1080,383,35.459999,303,80
1400000US06037311802,6037311802,2015,434,232,53.459999,191,41
1400000US06037320101,6037320101,2015,647,566,87.480003,550,16
1400000US06037320102,6037320102,2015,1966,1509,76.75,1317,192
1400000US06037320201,6037320201,2015,1549,1415,91.349998,1328,87
1400000US06037320202,6037320202,2015,638,531,83.230003,455,76
1400000US06037320300,6037320300,2015,2297,1763,76.75,1643,120
1400000US06037400205,6037400205,2015,102,101,99.019997,101,0
1400000US06037400208,6037400208,2015,585,51,8.7200003,39,12
1400000US06037400304,6037400304,2015,976,503,51.540001,407,96
1400000US06037400402,6037400402,2015,2496,505,20.23,390,115
1400000US06037400403,6037400403,2015,49,49,100,49,0
1400000US06037400404,6037400404,2015,627,108,17.219999,70,38
1400000US06037400501,6037400501,2015,915,128,13.99,99,29
1400000US06037400602,6037400602,2015,737,481,65.260002,398,83
1400000US06037400605,6037400605,2015,307,259,84.360001,229,30
1400000US06037400801,6037400801,2015,2216,981,44.27,713,268
1400000US06037401001,6037401001,2015,679,129,19,94,35
1400000US06037401202,6037401202,2015,881,370,42,296,74
1400000US06037401203,6037401203,2015,127,67,52.759998,58,9
1400000US06037401311,6037401311,2015,1192,364,30.540001,274,90
1400000US06037401312,6037401312,2015,2281,816,35.77,622,194
1400000US06037401601,6037401601,2015,496,110,22.18,84,26
1400000US06037401602,6037401602,2015,2666,964,36.16,737,227
1400000US06037401705,6037401705,2015,604,274,45.360001,241,33
1400000US06037401707,6037401707,2015,414,376,90.82,324,52
1400000US06037401801,6037401801,2015,656,101,15.4,72,29
1400000US06037401802,6037401802,2015,3055,917,30.02,659,258
1400000US06037401902,6037401902,2015,1958,750,38.299999,570,180
1400000US06037402001,6037402001,2015,310,247,79.68,188,59
1400000US06037402002,6037402002,2015,359,217,60.450001,163,54
1400000US06037402101,6037402101,2015,368,337,91.580002,304,33
1400000US06037402102,6037402102,2015,2229,1905,85.459999,1607,298
1400000US06037402200,6037402200,2015,233,196,84.120003,176,20
1400000US06037402301,6037402301,2015,1438,1282,89.150002,1114,168
1400000US06037402303,6037402303,2015,412,373,90.529999,343,30
1400000US06037402403,6037402403,2015,911,453,49.73,356,97
1400000US06037402405,6037402405,2015,1070,946,88.410004,829,117
1400000US06037402406,6037402406,2015,1105,1036,93.760002,942,94
1400000US06037402501,6037402501,2015,1338,1280,95.669998,1183,97
1400000US06037402503,6037402503,2015,897,837,93.309998,769,68
1400000US06037402504,6037402504,2015,597,563,94.300003,500,63
1400000US06037402601,6037402601,2015,618,575,93.040001,515,60
1400000US06037402702,6037402702,2015,1070,961,89.809998,873,88
1400000US06037402703,6037402703,2015,333,289,86.790001,250,39
1400000US06037402705,6037402705,2015,632,599,94.779999,554,45
1400000US06037402706,6037402706,2015,276,256,92.75,233,23
1400000US06037402902,6037402902,2015,781,732,93.730003,664,68
1400000US06037402903,6037402903,2015,1752,1646,93.949997,1472,174
1400000US06037403000,6037403000,2015,3160,2895,91.610001,2513,382
1400000US06037403316,6037403316,2015,1092,596,54.580002,464,132
1400000US06037403317,6037403317,2015,2241,1078,48.099998,815,263
1400000US06037403318,6037403318,2015,516,330,63.950001,270,60
1400000US06037403320,6037403320,2015,379,124,32.720001,96,28
1400000US06037403321,6037403321,2015,387,248,64.080002,184,64
1400000US06037403323,6037403323,2015,1759,204,11.6,99,105
1400000US06037403324,6037403324,2015,652,79,12.12,40,39
1400000US06037403325,6037403325,2015,4150,399,9.6099997,204,195
1400000US06037403326,6037403326,2015,554,121,21.84,62,59
1400000US06037403327,6037403327,2015,421,204,48.459999,156,48
1400000US06037403401,6037403401,2015,436,114,26.15,73,41
1400000US06037403402,6037403402,2015,3256,475,14.59,233,242
1400000US06037403404,6037403404,2015,1347,188,13.96,91,97
1400000US06037403407,6037403407,2015,587,68,11.58,27,41
1400000US06037403408,6037403408,2015,985,303,30.76,211,92
1400000US06037403409,6037403409,2015,611,109,17.84,58,51
1400000US06037403601,6037403601,2015,888,544,61.259998,408,136
1400000US06037403702,6037403702,2015,2157,1107,51.32,880,227
1400000US06037403703,6037403703,2015,449,284,63.25,220,64
1400000US06037403722,6037403722,2015,720,417,57.919998,326,91
1400000US06037403801,6037403801,2015,1217,833,68.449997,676,157
1400000US06037403901,6037403901,2015,57,29,50.880001,24,5
1400000US06037403902,6037403902,2015,456,251,55.040001,194,57
1400000US06037404000,6037404000,2015,851,699,82.139999,606,93
1400000US06037404100,6037404100,2015,567,503,88.709999,443,60
1400000US06037404201,6037404201,2015,2282,1764,77.300003,1476,288
1400000US06037404203,6037404203,2015,249,201,80.720001,179,22
1400000US06037404401,6037404401,2015,782,648,82.860001,523,125
1400000US06037404402,6037404402,2015,813,706,86.839996,602,104
1400000US06037404503,6037404503,2015,332,304,91.57,261,43
1400000US06037404504,6037404504,2015,473,426,90.059998,390,36
1400000US06037404600,6037404600,2015,1404,1100,78.349998,874,226
1400000US06037404701,6037404701,2015,1019,948,93.029999,817,131
1400000US06037404702,6037404702,2015,778,694,89.199997,609,85
1400000US06037404804,6037404804,2015,2770,2457,88.699997,2028,429
1400000US06037404805,6037404805,2015,576,515,89.410004,432,83
1400000US06037404806,6037404806,2015,1175,1061,90.300003,924,137
1400000US06037404901,6037404901,2015,591,501,84.769997,436,65
1400000US06037404903,6037404903,2015,583,515,88.339996,443,72
1400000US06037405001,6037405001,2015,998,870,87.169998,735,135
1400000US06037405002,6037405002,2015,429,403,93.940002,377,26
1400000US06037405101,6037405101,2015,1886,1674,88.760002,1435,239
1400000US06037405201,6037405201,2015,2458,2163,88,1818,345
1400000US06037405202,6037405202,2015,774,681,87.980003,593,88
1400000US06037405302,6037405302,2015,551,453,82.209999,384,69
1400000US06037405400,6037405400,2015,252,215,85.32,186,29
1400000US06037405600,6037405600,2015,997,727,72.919998,579,148
1400000US06037405701,6037405701,2015,1269,1012,79.75,839,173
1400000US06037405702,6037405702,2015,1326,920,69.379997,723,197
1400000US06037405800,6037405800,2015,1774,1383,77.959999,1145,238
1400000US06037406000,6037406000,2015,1952,1389,71.160004,1045,344
1400000US06037406103,6037406103,2015,638,447,70.059998,338,109
1400000US06037406201,6037406201,2015,1359,1029,75.720001,844,185
1400000US06037406300,6037406300,2015,2420,1233,50.950001,923,310
1400000US06037406413,6037406413,2015,1391,935,67.220001,717,218
1400000US06037406601,6037406601,2015,3986,2904,72.849998,2204,700
1400000US06037406602,6037406602,2015,383,307,80.160004,231,76
1400000US06037406701,6037406701,2015,408,326,79.900002,260,66
1400000US06037406702,6037406702,2015,313,249,79.550003,197,52
1400000US06037406801,6037406801,2015,1889,1399,74.059998,1044,355
1400000US06037406903,6037406903,2015,2400,1647,68.629997,1309,338
1400000US06037407001,6037407001,2015,424,410,96.699997,363,47
1400000US06037407002,6037407002,2015,717,682,95.120003,612,70
1400000US06037407101,6037407101,2015,1962,1784,90.93,1612,172
1400000US06037407201,6037407201,2015,364,337,92.580002,292,45
1400000US06037407301,6037407301,2015,393,367,93.379997,333,34
1400000US06037407302,6037407302,2015,1266,1197,94.550003,1038,159
1400000US06037407501,6037407501,2015,921,775,84.150002,630,145
1400000US06037407502,6037407502,2015,696,629,90.370003,556,73
1400000US06037407602,6037407602,2015,747,696,93.169998,612,84
1400000US06037407701,6037407701,2015,606,569,93.889999,521,48
1400000US06037407702,6037407702,2015,1774,1565,88.220001,1356,209
1400000US06037407801,6037407801,2015,596,536,89.93,470,66
1400000US06037407802,6037407802,2015,1438,1302,90.540001,1105,197
1400000US06037407901,6037407901,2015,533,460,86.300003,403,57
1400000US06037408003,6037408003,2015,121,106,87.599998,92,14
1400000US06037408135,6037408135,2015,688,597,86.769997,520,77
1400000US06037408136,6037408136,2015,416,299,71.879997,255,44
1400000US06037408137,6037408137,2015,808,623,77.099998,481,142
1400000US06037408138,6037408138,2015,512,464,90.629997,414,50
1400000US06037408139,6037408139,2015,510,447,87.650002,393,54
1400000US06037408140,6037408140,2015,678,599,88.349998,516,83
1400000US06037408141,6037408141,2015,2486,1936,77.879997,1616,320
1400000US06037408212,6037408212,2015,747,357,47.790001,234,123
1400000US06037408213,6037408213,2015,429,353,82.279999,301,52
1400000US06037408301,6037408301,2015,506,489,96.639999,443,46
1400000US06037408302,6037408302,2015,540,379,70.190002,300,79
1400000US06037408401,6037408401,2015,10,6,60,6,0
1400000US06037408402,6037408402,2015,1216,965,79.360001,795,170
1400000US06037408503,6037408503,2015,786,380,48.349998,278,102
1400000US06037408504,6037408504,2015,549,345,62.84,272,73
1400000US06037408505,6037408505,2015,2347,1634,69.620003,1320,314
1400000US06037408623,6037408623,2015,1960,1086,55.41,818,268
1400000US06037408624,6037408624,2015,288,247,85.760002,196,51
1400000US06037408625,6037408625,2015,1662,659,39.650002,469,190
1400000US06037408631,6037408631,2015,543,433,79.739998,343,90
1400000US06037408705,6037408705,2015,3329,1770,53.169998,1261,509
1400000US06037408707,6037408707,2015,982,187,19.040001,91,96
1400000US06037408722,6037408722,2015,688,286,41.57,198,88
1400000US06037408724,6037408724,2015,520,459,88.269997,409,50
1400000US06037408725,6037408725,2015,750,444,59.200001,346,98
1400000US06037408800,6037408800,2015,29,23,79.309998,23,0
1400000US06037408900,6037408900,2015,1814,702,38.700001,511,191
1400000US06037409000,6037409000,2015,559,509,91.059998,457,52
1400000US06037409100,6037409100,2015,215,181,84.190002,162,19
1400000US06037430003,6037430003,2015,359,212,59.049999,158,54
1400000US06037430005,6037430005,2015,337,280,83.089996,241,39
1400000US06037430101,6037430101,2015,1839,1327,72.160004,1054,273
1400000US06037430102,6037430102,2015,324,274,84.57,236,38
1400000US06037430200,6037430200,2015,519,277,53.369999,203,74
1400000US06037430302,6037430302,2015,555,268,48.290001,190,78
1400000US06037430400,6037430400,2015,1419,202,14.24,133,69
1400000US06037430502,6037430502,2015,1138,262,23.02,203,59
1400000US06037430701,6037430701,2015,555,129,23.24,103,26
1400000US06037430721,6037430721,2015,3387,644,19.01,421,223
1400000US06037430801,6037430801,2015,827,183,22.129999,127,56
1400000US06037430802,6037430802,2015,1371,305,22.25,214,91
1400000US06037431002,6037431002,2015,662,421,63.599998,330,91
1400000US06037431003,6037431003,2015,1715,858,50.029999,628,230
1400000US06037431004,6037431004,2015,1762,1124,63.790001,842,282
1400000US06037431100,6037431100,2015,632,459,72.629997,343,116
1400000US06037431200,6037431200,2015,366,327,89.339996,284,43
1400000US06037431400,6037431400,2015,396,283,71.459999,227,56
1400000US06037431501,6037431501,2015,400,298,74.5,264,34
1400000US06037431502,6037431502,2015,839,617,73.540001,562,55
1400000US06037431600,6037431600,2015,468,116,24.790001,80,36
1400000US06037431701,6037431701,2015,1406,266,18.92,191,75
1400000US06037431800,6037431800,2015,2114,919,43.470001,582,337
1400000US06037431900,6037431900,2015,1045,412,39.43,295,117
1400000US06037432002,6037432002,2015,475,196,41.259998,137,59
1400000US06037432102,6037432102,2015,600,275,45.830002,194,81
1400000US06037432201,6037432201,2015,532,383,71.989998,283,100
1400000US06037432202,6037432202,2015,2686,2309,85.959999,1808,501
1400000US06037432300,6037432300,2015,949,846,89.150002,732,114
1400000US06037432401,6037432401,2015,3226,2876,89.150002,2511,365
1400000US06037432402,6037432402,2015,506,469,92.690002,427,42
1400000US06037432501,6037432501,2015,443,372,83.970001,327,45
1400000US06037432602,6037432602,2015,1428,1291,90.410004,1167,124
1400000US06037432801,6037432801,2015,602,594,98.669998,577,17
1400000US06037432902,6037432902,2015,510,438,85.879997,349,89
1400000US06037433103,6037433103,2015,477,459,96.230003,417,42
1400000US06037433200,6037433200,2015,3005,2897,96.410004,2622,275
1400000US06037433302,6037433302,2015,844,796,94.309998,710,86
1400000US06037433305,6037433305,2015,677,623,92.019997,582,41
1400000US06037433306,6037433306,2015,474,462,97.470001,427,35
1400000US06037433307,6037433307,2015,768,693,90.230003,606,87
1400000US06037433505,6037433505,2015,1486,1451,97.639999,1398,53
1400000US06037433803,6037433803,2015,2058,1863,90.519997,1652,211
1400000US06037433804,6037433804,2015,1263,1202,95.169998,1072,130
1400000US06037433901,6037433901,2015,522,503,96.360001,471,32
1400000US06037433903,6037433903,2015,1284,1180,91.900002,1104,76
1400000US06037434001,6037434001,2015,1446,1402,96.959999,1277,125
1400000US06037434003,6037434003,2015,1353,1274,94.160004,1150,124
1400000US06037434100,6037434100,2015,549,489,89.07,406,83
1400000US06037460002,6037460002,2015,633,247,39.02,179,68
1400000US06037460101,6037460101,2015,391,47,12.02,27,20
1400000US06037460200,6037460200,2015,179,55,30.73,44,11
1400000US06037460301,6037460301,2015,409,141,34.470001,112,29
1400000US06037460302,6037460302,2015,730,343,46.990002,282,61
1400000US06037460501,6037460501,2015,699,7,1,5,2
1400000US06037460502,6037460502,2015,644,11,1.71,8,3
1400000US06037460601,6037460601,2015,580,9,1.55,7,2
1400000US06037460700,6037460700,2015,2056,21,1.02,11,10
1400000US06037460900,6037460900,2015,1094,897,81.989998,808,89
1400000US06037461000,6037461000,2015,419,368,87.830002,330,38
1400000US06037461100,6037461100,2015,265,239,90.190002,227,12
1400000US06037461200,6037461200,2015,504,447,88.690002,397,50
1400000US06037461300,6037461300,2015,474,306,64.559998,240,66
1400000US06037461400,6037461400,2015,499,404,80.959999,360,44
1400000US06037461502,6037461502,2015,1114,1032,92.639999,930,102
1400000US06037461700,6037461700,2015,305,280,91.800003,262,18
1400000US06037462100,6037462100,2015,448,435,97.099998,401,34
1400000US06037462500,6037462500,2015,2442,1611,65.970001,1277,334
1400000US06037462600,6037462600,2015,1930,1264,65.489998,998,266
1400000US06037462700,6037462700,2015,383,366,95.559998,321,45
1400000US06037462900,6037462900,2015,159,148,93.080002,139,9
1400000US06037463000,6037463000,2015,2157,1596,73.989998,1384,212
1400000US06037463200,6037463200,2015,1196,909,76,770,139
1400000US06037463300,6037463300,2015,601,307,51.080002,223,84
1400000US06037463601,6037463601,2015,1193,817,68.480003,687,130
1400000US06037463800,6037463800,2015,435,161,37.009998,121,40
1400000US06037464000,6037464000,2015,998,719,72.040001,604,115
1400000US06037464101,6037464101,2015,1334,44,3.3,31,13
1400000US06037464200,6037464200,2015,1162,53,4.5599999,38,15
1400000US06037480002,6037480002,2015,963,145,15.06,99,46
1400000US06037480012,6037480012,2015,1629,665,40.82,441,224
1400000US06037480201,6037480201,2015,422,160,37.91,117,43
1400000US06037480202,6037480202,2015,486,233,47.939999,180,53
1400000US06037480302,6037480302,2015,488,345,70.699997,283,62
1400000US06037480304,6037480304,2015,3373,2466,73.110001,1988,478
1400000US06037480400,6037480400,2015,1756,1166,66.400002,905,261
1400000US06037480500,6037480500,2015,1879,293,15.59,199,94
1400000US06037480702,6037480702,2015,609,62,10.18,46,16
1400000US06037480703,6037480703,2015,699,97,13.88,71,26
1400000US06037480704,6037480704,2015,1496,250,16.709999,167,83
1400000US06037480803,6037480803,2015,488,362,74.18,281,81
1400000US06037480804,6037480804,2015,739,546,73.879997,429,117
1400000US06037480901,6037480901,2015,223,135,60.540001,121,14
1400000US06037480903,6037480903,2015,578,424,73.360001,352,72
1400000US06037481101,6037481101,2015,767,561,73.139999,463,98
1400000US06037481102,6037481102,2015,48,39,81.25,28,11
1400000US06037481103,6037481103,2015,2280,1771,77.68,1462,309
1400000US06037481203,6037481203,2015,1571,989,62.950001,777,212
1400000US06037481300,6037481300,2015,602,520,86.379997,369,151
1400000US06037481401,6037481401,2015,587,431,73.419998,328,103
1400000US06037481403,6037481403,2015,397,329,82.870003,290,39
1400000US06037481404,6037481404,2015,1803,918,50.919998,667,251
1400000US06037481500,6037481500,2015,2288,1383,60.450001,1070,313
1400000US06037481606,6037481606,2015,857,674,78.650002,516,158
1400000US06037481901,6037481901,2015,573,426,74.349998,347,79
1400000US06037482001,6037482001,2015,1126,644,57.189999,513,131
1400000US06037482002,6037482002,2015,1008,421,41.77,301,120
1400000US06037482101,6037482101,2015,894,686,76.730003,568,118
1400000US06037482102,6037482102,2015,785,435,55.41,333,102
1400000US06037482202,6037482202,2015,476,371,77.940002,304,67
1400000US06037482304,6037482304,2015,547,506,92.5,443,63
1400000US06037482401,6037482401,2015,476,420,88.239998,361,59
1400000US06037482403,6037482403,2015,1420,1266,89.150002,1093,173
1400000US06037482502,6037482502,2015,1239,1058,85.389999,931,127
1400000US06037482522,6037482522,2015,447,300,67.110001,223,77
1400000US06037482600,6037482600,2015,438,267,60.959999,229,38
1400000US06037482701,6037482701,2015,624,518,83.010002,438,80
1400000US06037482801,6037482801,2015,887,680,76.660004,543,137
1400000US06037500202,6037500202,2015,4223,1983,46.959999,1431,552
1400000US06037500203,6037500203,2015,566,100,17.67,80,20
1400000US06037500300,6037500300,2015,447,317,70.919998,245,72
1400000US06037500402,6037500402,2015,762,668,87.660004,558,110
1400000US06037500404,6037500404,2015,426,361,84.739998,290,71
1400000US06037500600,6037500600,2015,847,768,90.669998,662,106
1400000US06037500700,6037500700,2015,439,381,86.790001,295,86
1400000US06037500800,6037500800,2015,3221,2515,78.080002,2021,494
1400000US06037500900,6037500900,2015,577,516,89.43,449,67
1400000US06037501001,6037501001,2015,367,310,84.470001,273,37
1400000US06037501002,6037501002,2015,1203,1016,84.459999,853,163
1400000US06037501200,6037501200,2015,414,335,80.919998,275,60
1400000US06037501302,6037501302,2015,1677,1341,79.959999,1140,201
1400000US06037501400,6037501400,2015,2138,1637,76.57,1326,311
1400000US06037501600,6037501600,2015,485,361,74.43,306,55
1400000US06037501700,6037501700,2015,795,244,30.690001,172,72
1400000US06037501804,6037501804,2015,420,389,92.620003,339,50
1400000US06037502003,6037502003,2015,460,413,89.779999,366,47
1400000US06037502005,6037502005,2015,713,515,72.230003,409,106
1400000US06037502200,6037502200,2015,490,394,80.410004,345,49
1400000US06037502303,6037502303,2015,2721,2247,82.580002,1870,377
1400000US06037502401,6037502401,2015,1480,1219,82.360001,999,220
1400000US06037502602,6037502602,2015,470,427,90.849998,354,73
1400000US06037502603,6037502603,2015,560,458,81.790001,364,94
1400000US06037502604,6037502604,2015,453,362,79.910004,294,68
1400000US06037502700,6037502700,2015,899,656,72.970001,472,184
1400000US06037502801,6037502801,2015,3921,2735,69.75,1855,880
1400000US06037503103,6037503103,2015,520,483,92.879997,437,46
1400000US06037503105,6037503105,2015,694,627,90.349998,548,79
1400000US06037503201,6037503201,2015,347,265,76.370003,210,55
1400000US06037503202,6037503202,2015,431,349,80.970001,279,70
1400000US06037503302,6037503302,2015,3496,2618,74.889999,2100,518
1400000US06037503402,6037503402,2015,652,224,34.360001,157,67
1400000US06037503501,6037503501,2015,1111,716,64.449997,584,132
1400000US06037503502,6037503502,2015,676,460,68.050003,373,87
1400000US06037503602,6037503602,2015,2624,1213,46.23,976,237
1400000US06037503701,6037503701,2015,1731,791,45.700001,611,180
1400000US06037503705,6037503705,2015,248,123,49.599998,105,18
1400000US06037503801,6037503801,2015,1356,579,42.700001,484,95
1400000US06037503802,6037503802,2015,457,220,48.139999,179,41
1400000US06037503902,6037503902,2015,573,236,41.189999,194,42
1400000US06037504002,6037504002,2015,1348,625,46.360001,520,105
1400000US06037504101,6037504101,2015,336,265,78.870003,226,39
1400000US06037504200,6037504200,2015,2111,1773,83.989998,1517,256
1400000US06037530005,6037530005,2015,2783,2270,81.57,1856,414
1400000US06037530007,6037530007,2015,2049,1690,82.480003,1463,227
1400000US06037530101,6037530101,2015,482,438,90.870003,391,47
1400000US06037530102,6037530102,2015,4750,4143,87.220001,3603,540
1400000US06037530202,6037530202,2015,974,898,92.199997,791,107
1400000US06037530203,6037530203,2015,652,571,87.580002,494,77
1400000US06037530301,6037530301,2015,3736,3409,91.25,3367,42
1400000US06037530400,6037530400,2015,1400,1260,90,1161,99
1400000US06037530500,6037530500,2015,768,679,88.410004,672,7
1400000US06037530603,6037530603,2015,844,679,80.449997,648,31
1400000US06037530700,6037530700,2015,603,538,89.220001,438,100
1400000US06037530801,6037530801,2015,507,464,91.519997,427,37
1400000US06037530902,6037530902,2015,797,719,90.209999,710,9
1400000US06037531000,6037531000,2015,2888,2358,81.650002,2280,78
1400000US06037531101,6037531101,2015,2917,2007,68.800003,1914,93
1400000US06037531102,6037531102,2015,1344,1261,93.82,1245,16
1400000US06037531201,6037531201,2015,951,875,92.010002,867,8
1400000US06037531202,6037531202,2015,188,175,93.089996,162,13
1400000US06037531302,6037531302,2015,1069,964,90.18,933,31
1400000US06037531502,6037531502,2015,1198,1108,92.489998,1096,12
1400000US06037531503,6037531503,2015,754,689,91.379997,674,15
1400000US06037531603,6037531603,2015,1396,1278,91.550003,1253,25
1400000US06037531701,6037531701,2015,536,488,91.040001,393,95
1400000US06037531702,6037531702,2015,649,599,92.300003,553,46
1400000US06037531800,6037531800,2015,859,785,91.389999,698,87
1400000US06037531902,6037531902,2015,620,576,92.900002,522,54
1400000US06037532002,6037532002,2015,618,488,78.959999,407,81
1400000US06037532101,6037532101,2015,99,77,77.779999,70,7
1400000US06037532102,6037532102,2015,994,922,92.760002,851,71
1400000US06037532200,6037532200,2015,428,299,69.860001,287,12
1400000US06037532302,6037532302,2015,513,428,83.43,374,54
1400000US06037532303,6037532303,2015,920,786,85.43,626,160
1400000US06037532304,6037532304,2015,3,3,100,3,0
1400000US06037532500,6037532500,2015,3477,3187,91.660004,3082,105
1400000US06037532605,6037532605,2015,238,222,93.279999,195,27
1400000US06037532606,6037532606,2015,233,221,94.849998,195,26
1400000US06037532607,6037532607,2015,1751,1511,86.290001,1494,17
1400000US06037532700,6037532700,2015,691,670,96.959999,655,15
1400000US06037532800,6037532800,2015,2616,2437,93.160004,2428,9
1400000US06037532900,6037532900,2015,2086,2029,97.269997,2022,7
1400000US06037533103,6037533103,2015,3054,2905,95.120003,2697,208
1400000US06037533108,6037533108,2015,2781,2649,95.25,2606,43
1400000US06037533201,6037533201,2015,676,637,94.230003,624,13
1400000US06037533204,6037533204,2015,574,521,90.769997,515,6
1400000US06037533402,6037533402,2015,1488,1348,90.589996,1260,88
1400000US06037533403,6037533403,2015,1744,1627,93.290001,1598,29
1400000US06037533501,6037533501,2015,1909,1798,94.190002,1754,44
1400000US06037533504,6037533504,2015,660,601,91.059998,582,19
1400000US06037533601,6037533601,2015,1062,971,91.43,947,24
1400000US06037533602,6037533602,2015,2553,2377,93.110001,2256,121
1400000US06037533603,6037533603,2015,3147,2827,89.830002,2637,190
1400000US06037533703,6037533703,2015,715,656,91.75,577,79
1400000US06037533804,6037533804,2015,789,693,87.830002,610,83
1400000US06037533901,6037533901,2015,3899,3562,91.360001,3189,373
1400000US06037533902,6037533902,2015,755,664,87.949997,606,58
1400000US06037534001,6037534001,2015,878,802,91.339996,720,82
1400000US06037534002,6037534002,2015,983,926,94.199997,812,114
1400000US06037534102,6037534102,2015,1194,1065,89.199997,977,88
1400000US06037534201,6037534201,2015,1090,1017,93.300003,943,74
1400000US06037534302,6037534302,2015,540,488,90.370003,480,8
1400000US06037534404,6037534404,2015,1473,1319,89.550003,1299,20
1400000US06037534405,6037534405,2015,1781,1656,92.980003,1646,10
1400000US06037534406,6037534406,2015,1394,1248,89.529999,1232,16
1400000US06037534501,6037534501,2015,1123,1017,90.559998,939,78
1400000US06037534803,6037534803,2015,797,731,91.720001,725,6
1400000US06037534804,6037534804,2015,463,450,97.190002,400,50
1400000US06037534900,6037534900,2015,2331,2187,93.82,1981,206
1400000US06037535001,6037535001,2015,1775,1680,94.650002,1668,12
1400000US06037535101,6037535101,2015,2438,2247,92.169998,2191,56
1400000US06037535102,6037535102,2015,674,565,83.830002,565,0
1400000US06037535300,6037535300,2015,888,826,93.019997,805,21
1400000US06037535501,6037535501,2015,581,540,92.940002,531,9
1400000US06037535603,6037535603,2015,534,509,95.32,494,15
1400000US06037535604,6037535604,2015,560,535,95.540001,523,12
1400000US06037535605,6037535605,2015,750,716,95.470001,698,18
1400000US06037535607,6037535607,2015,4197,3779,90.040001,3611,168
1400000US06037535701,6037535701,2015,738,637,86.309998,608,29
1400000US06037535702,6037535702,2015,3445,2937,85.25,2570,367
1400000US06037535803,6037535803,2015,482,468,97.099998,457,11
1400000US06037535901,6037535901,2015,1823,1413,77.510002,1291,122
1400000US06037536000,6037536000,2015,2981,2782,93.32,2534,248
1400000US06037536103,6037536103,2015,654,536,81.959999,515,21
1400000US06037536104,6037536104,2015,1590,1190,74.839996,1012,178
1400000US06037536201,6037536201,2015,1054,950,90.129997,827,123
1400000US06037540000,6037540000,2015,2773,2677,96.540001,2391,286
1400000US06037540101,6037540101,2015,3539,3382,95.559998,3005,377
1400000US06037540202,6037540202,2015,1966,1898,96.540001,1768,130
1400000US06037540203,6037540203,2015,593,582,98.150002,523,59
1400000US06037540300,6037540300,2015,528,503,95.269997,444,59
1400000US06037540400,6037540400,2015,338,333,98.519997,332,1
1400000US06037540502,6037540502,2015,812,793,97.660004,714,79
1400000US06037540600,6037540600,2015,510,382,74.900002,367,15
1400000US06037540700,6037540700,2015,2584,1983,76.739998,1803,180
1400000US06037540800,6037540800,2015,999,955,95.599998,905,50
1400000US06037540901,6037540901,2015,706,669,94.760002,663,6
1400000US06037540902,6037540902,2015,566,411,72.610001,394,17
1400000US06037541003,6037541003,2015,431,321,74.480003,266,55
1400000US06037541100,6037541100,2015,349,256,73.349998,239,17
1400000US06037541200,6037541200,2015,884,682,77.150002,628,54
1400000US06037541300,6037541300,2015,1215,720,59.259998,687,33
1400000US06037541401,6037541401,2015,450,380,84.440002,343,37
1400000US06037541500,6037541500,2015,619,472,76.25,435,37
1400000US06037541603,6037541603,2015,977,886,90.690002,827,59
1400000US06037541605,6037541605,2015,652,497,76.230003,484,13
1400000US06037541700,6037541700,2015,3510,3384,96.410004,3117,267
1400000US06037541802,6037541802,2015,721,706,97.919998,627,79
1400000US06037542000,6037542000,2015,1533,1148,74.889999,1097,51
1400000US06037542104,6037542104,2015,742,648,87.330002,605,43
1400000US06037542106,6037542106,2015,3327,2439,73.309998,2238,201
1400000US06037542200,6037542200,2015,766,581,75.849998,545,36
1400000US06037542402,6037542402,2015,3319,2525,76.080002,2360,165
1400000US06037542601,6037542601,2015,462,268,58.009998,266,2
1400000US06037542700,6037542700,2015,1575,1262,80.129997,1213,49
1400000US06037542800,6037542800,2015,506,408,80.629997,368,40
1400000US06037542900,6037542900,2015,559,412,73.699997,368,44
1400000US06037543000,6037543000,2015,897,700,78.040001,628,72
1400000US06037543100,6037543100,2015,870,674,77.470001,623,51
1400000US06037543201,6037543201,2015,624,505,80.93,478,27
1400000US06037543203,6037543203,2015,393,276,70.230003,256,20
1400000US06037543304,6037543304,2015,283,194,68.550003,154,40
1400000US06037543306,6037543306,2015,367,233,63.490002,177,56
1400000US06037543321,6037543321,2015,670,298,44.48,194,104
1400000US06037543322,6037543322,2015,1132,827,73.059998,729,98
1400000US06037543400,6037543400,2015,340,258,75.879997,208,50
1400000US06037543501,6037543501,2015,1656,1140,68.839996,967,173
1400000US06037543503,6037543503,2015,1150,866,75.300003,780,86
1400000US06037543601,6037543601,2015,962,632,65.699997,504,128
1400000US06037543607,6037543607,2015,420,275,65.480003,197,78
1400000US06037543701,6037543701,2015,3199,1912,59.77,1557,355
1400000US06037543705,6037543705,2015,564,485,85.989998,423,62
1400000US06037543801,6037543801,2015,678,511,75.370003,396,115
1400000US06037543903,6037543903,2015,1420,989,69.650002,804,185
1400000US06037544001,6037544001,2015,570,441,77.370003,371,70
1400000US06037544002,6037544002,2015,1131,754,66.669998,634,120
1400000US06037550101,6037550101,2015,278,211,75.900002,147,64
1400000US06037550201,6037550201,2015,284,224,78.870003,163,61
1400000US06037550202,6037550202,2015,368,261,70.919998,190,71
1400000US06037550301,6037550301,2015,497,341,68.610001,247,94
1400000US06037550501,6037550501,2015,644,435,67.550003,310,125
1400000US06037550602,6037550602,2015,683,370,54.169998,278,92
1400000US06037550700,6037550700,2015,2282,1411,61.830002,1008,403
1400000US06037550801,6037550801,2015,849,565,66.550003,413,152
1400000US06037550901,6037550901,2015,4155,2550,61.369999,1805,745
1400000US06037551001,6037551001,2015,842,434,51.540001,321,113
1400000US06037551002,6037551002,2015,1422,863,60.689999,615,248
1400000US06037551101,6037551101,2015,620,556,89.68,445,111
1400000US06037551102,6037551102,2015,247,136,55.060001,113,23
1400000US06037551201,6037551201,2015,522,403,77.199997,314,89
1400000US06037551203,6037551203,2015,1108,845,76.260002,635,210
1400000US06037551204,6037551204,2015,567,419,73.900002,348,71
1400000US06037551300,6037551300,2015,3747,2362,63.040001,1614,748
1400000US06037551402,6037551402,2015,699,475,67.949997,354,121
1400000US06037551501,6037551501,2015,2410,1828,75.849998,1331,497
1400000US06037551700,6037551700,2015,434,355,81.800003,288,67
1400000US06037551801,6037551801,2015,1266,712,56.240002,605,107
1400000US06037551802,6037551802,2015,748,540,72.190002,394,146
1400000US06037551900,6037551900,2015,441,378,85.709999,317,61
1400000US06037552001,6037552001,2015,403,348,86.349998,299,49
1400000US06037552100,6037552100,2015,3484,2760,79.220001,2317,443
1400000US06037552200,6037552200,2015,411,378,91.970001,333,45
1400000US06037552301,6037552301,2015,469,394,84.010002,335,59
1400000US06037552302,6037552302,2015,1500,1215,81,1039,176
1400000US06037552601,6037552601,2015,475,419,88.209999,384,35
1400000US06037552602,6037552602,2015,603,521,86.400002,456,65
1400000US06037552700,6037552700,2015,697,613,87.949997,567,46
1400000US06037552800,6037552800,2015,2283,1818,79.629997,1567,251
1400000US06037553000,6037553000,2015,505,416,82.379997,352,64
1400000US06037553100,6037553100,2015,3261,2733,83.809998,2101,632
1400000US06037553300,6037553300,2015,506,458,90.510002,335,123
1400000US06037553502,6037553502,2015,6174,5716,92.580002,5113,603
1400000US06037553504,6037553504,2015,758,730,96.309998,692,38
1400000US06037553601,6037553601,2015,610,592,97.050003,550,42
1400000US06037553701,6037553701,2015,602,567,94.190002,530,37
1400000US06037553702,6037553702,2015,1490,1417,95.099998,1347,70
1400000US06037553802,6037553802,2015,1205,1081,89.709999,984,97
1400000US06037553901,6037553901,2015,1085,1012,93.269997,919,93
1400000US06037553902,6037553902,2015,1648,1535,93.139999,1430,105
1400000US06037554002,6037554002,2015,738,684,92.68,599,85
1400000US06037554106,6037554106,2015,655,583,89.010002,492,91
1400000US06037554201,6037554201,2015,912,813,89.139999,674,139
1400000US06037554405,6037554405,2015,777,621,79.919998,499,122
1400000US06037554511,6037554511,2015,2011,490,24.370001,335,155
1400000US06037554512,6037554512,2015,1581,340,21.51,225,115
1400000US06037554514,6037554514,2015,677,485,71.639999,408,77
1400000US06037554515,6037554515,2015,776,260,33.509998,168,92
1400000US06037554516,6037554516,2015,3896,1314,33.73,911,403
1400000US06037554517,6037554517,2015,759,121,15.94,74,47
1400000US06037554518,6037554518,2015,691,127,18.379999,80,47
1400000US06037554521,6037554521,2015,1955,961,49.16,737,224
1400000US06037554522,6037554522,2015,1088,467,42.919998,358,109
1400000US06037554700,6037554700,2015,362,335,92.540001,308,27
1400000US06037554801,6037554801,2015,699,524,74.959999,415,109
1400000US06037554802,6037554802,2015,1638,944,57.630001,711,233
1400000US06037555001,6037555001,2015,474,424,89.449997,385,39
1400000US06037555002,6037555002,2015,390,320,82.050003,278,42
1400000US06037555105,6037555105,2015,2146,1581,73.669998,1336,245
1400000US06037555106,6037555106,2015,416,382,91.830002,343,39
1400000US06037555107,6037555107,2015,548,494,90.150002,449,45
1400000US06037555211,6037555211,2015,414,399,96.379997,370,29
1400000US06037555212,6037555212,2015,428,417,97.43,386,31
1400000US06037555300,6037555300,2015,414,297,71.739998,224,73
1400000US06037570001,6037570001,2015,3972,2169,54.610001,1506,663
1400000US06037570002,6037570002,2015,811,710,87.550003,588,122
1400000US06037570100,6037570100,2015,566,530,93.639999,478,52
1400000US06037570202,6037570202,2015,922,828,89.800003,706,122
1400000US06037570203,6037570203,2015,700,641,91.57,575,66
1400000US06037570402,6037570402,2015,1363,1227,90.019997,1057,170
1400000US06037570403,6037570403,2015,816,700,85.779999,654,46
1400000US06037570504,6037570504,2015,4332,3428,79.129997,2946,482
1400000US06037570601,6037570601,2015,603,557,92.370003,472,85
1400000US06037570602,6037570602,2015,913,823,90.139999,715,108
1400000US06037570701,6037570701,2015,637,503,78.959999,441,62
1400000US06037570800,6037570800,2015,1314,694,52.82,468,226
1400000US06037570902,6037570902,2015,706,313,44.330002,207,106
1400000US06037571000,6037571000,2015,547,189,34.549999,141,48
1400000US06037571101,6037571101,2015,379,200,52.77,150,50
1400000US06037571102,6037571102,2015,3492,1731,49.57,1274,457
1400000US06037571202,6037571202,2015,1586,741,46.720001,518,223
1400000US06037571300,6037571300,2015,1293,844,65.269997,635,209
1400000US06037571400,6037571400,2015,491,252,51.32,180,72
1400000US06037571502,6037571502,2015,601,543,90.349998,467,76
1400000US06037571701,6037571701,2015,1936,1764,91.120003,1500,264
1400000US06037571703,6037571703,2015,929,879,94.620003,794,85
1400000US06037571800,6037571800,2015,528,206,39.02,154,52
1400000US06037571900,6037571900,2015,2586,1298,50.189999,963,335
1400000US06037572202,6037572202,2015,1622,1420,87.550003,1226,194
1400000US06037572500,6037572500,2015,601,555,92.349998,490,65
1400000US06037572600,6037572600,2015,791,735,92.919998,641,94
1400000US06037572700,6037572700,2015,755,707,93.639999,605,102
1400000US06037573101,6037573101,2015,958,761,79.440002,699,62
1400000US06037573201,6037573201,2015,768,723,94.139999,637,86
1400000US06037573300,6037573300,2015,437,369,84.440002,301,68
1400000US06037573402,6037573402,2015,1603,1437,89.639999,1243,194
1400000US06037573601,6037573601,2015,612,390,63.73,341,49
1400000US06037573700,6037573700,2015,851,245,28.790001,170,75
1400000US06037573800,6037573800,2015,396,157,39.650002,120,37
1400000US06037573902,6037573902,2015,945,252,26.67,186,66
1400000US06037574000,6037574000,2015,1006,271,26.940001,207,64
1400000US06037574100,6037574100,2015,1338,553,41.330002,457,96
1400000US06037574201,6037574201,2015,549,277,50.459999,207,70
1400000US06037574202,6037574202,2015,289,245,84.779999,230,15
1400000US06037574300,6037574300,2015,1877,626,33.349998,460,166
1400000US06037574400,6037574400,2015,4314,1923,44.580002,1543,380
1400000US06037574500,6037574500,2015,834,352,42.209999,255,97
1400000US06037574602,6037574602,2015,488,404,82.790001,345,59
1400000US06037574901,6037574901,2015,576,100,17.360001,79,21
1400000US06037575002,6037575002,2015,371,292,78.709999,251,41
1400000US06037575101,6037575101,2015,940,837,89.040001,795,42
1400000US06037575201,6037575201,2015,936,745,79.589996,712,33
1400000US06037575300,6037575300,2015,5339,3284,61.509998,2851,433
1400000US06037575401,6037575401,2015,1704,1378,80.870003,1282,96
1400000US06037575402,6037575402,2015,414,327,78.989998,296,31
1400000US06037575901,6037575901,2015,698,628,89.970001,611,17
1400000US06037576200,6037576200,2015,1183,1042,88.080002,980,62
1400000US06037576301,6037576301,2015,1287,994,77.230003,924,70
1400000US06037576401,6037576401,2015,1155,998,86.410004,972,26
1400000US06037576501,6037576501,2015,1184,1087,91.809998,1013,74
1400000US06037576801,6037576801,2015,797,723,90.720001,642,81
1400000US06037576903,6037576903,2015,802,748,93.269997,695,53
1400000US06037577000,6037577000,2015,4936,3140,63.610001,2676,464
1400000US06037577100,6037577100,2015,857,403,47.02,313,90
1400000US06037577501,6037577501,2015,352,32,9.0900002,29,3
1400000US06037577602,6037577602,2015,339,120,35.400002,97,23
1400000US06037577606,6037577606,2015,1635,285,17.43,228,57
1400000US06037577700,6037577700,2015,1071,861,80.389999,693,168
1400000US06037577800,6037577800,2015,655,451,68.849998,312,139
1400000US06037577900,6037577900,2015,409,311,76.040001,294,17
1400000US06037578000,6037578000,2015,3669,2926,79.75,2489,437
1400000US06037599000,6037599000,2015,616,419,68.019997,294,125
1400000US06037600201,6037600201,2015,957,867,90.599998,864,3
1400000US06037600302,6037600302,2015,1878,1649,87.809998,1552,97
1400000US06037600303,6037600303,2015,871,758,87.029999,725,33
1400000US06037600501,6037600501,2015,384,324,84.379997,321,3
1400000US06037600602,6037600602,2015,1908,1561,81.809998,1455,106
1400000US06037600703,6037600703,2015,614,552,89.900002,477,75
1400000US06037600801,6037600801,2015,623,516,82.830002,479,37
1400000US06037600911,6037600911,2015,703,563,80.089996,520,43
1400000US06037601001,6037601001,2015,76,75,98.68,74,1
1400000US06037601002,6037601002,2015,849,701,82.57,627,74
1400000US06037601202,6037601202,2015,1208,1017,84.190002,918,99
1400000US06037601211,6037601211,2015,1746,1157,66.269997,1072,85
1400000US06037601212,6037601212,2015,358,321,89.660004,290,31
1400000US06037601301,6037601301,2015,704,558,79.260002,476,82
1400000US06037601303,6037601303,2015,1305,1044,80,907,137
1400000US06037601401,6037601401,2015,789,599,75.919998,544,55
1400000US06037601402,6037601402,2015,717,586,81.730003,520,66
1400000US06037601502,6037601502,2015,1382,1228,88.860001,1188,40
1400000US06037601600,6037601600,2015,2277,2063,90.599998,1995,68
1400000US06037601700,6037601700,2015,1973,1787,90.57,1584,203
1400000US06037601802,6037601802,2015,570,541,94.910004,512,29
1400000US06037602003,6037602003,2015,491,401,81.669998,368,33
1400000US06037602104,6037602104,2015,607,551,90.769997,494,57
1400000US06037602106,6037602106,2015,1584,1346,84.970001,1183,163
1400000US06037602201,6037602201,2015,3437,2098,61.040001,1750,348
1400000US06037602302,6037602302,2015,1942,885,45.57,605,280
1400000US06037602402,6037602402,2015,740,564,76.220001,464,100
1400000US06037602403,6037602403,2015,1617,1381,85.410004,1240,141
1400000US06037602404,6037602404,2015,577,511,88.559998,452,59
1400000US06037602505,6037602505,2015,936,809,86.43,734,75
1400000US06037602506,6037602506,2015,758,657,86.68,604,53
1400000US06037602511,6037602511,2015,1887,1727,91.519997,1593,134
1400000US06037602601,6037602601,2015,526,388,73.760002,340,48
1400000US06037602700,6037602700,2015,476,392,82.349998,346,46
1400000US06037602801,6037602801,2015,1295,1141,88.110001,1045,96
1400000US06037602802,6037602802,2015,1231,1151,93.5,1091,60
1400000US06037603006,6037603006,2015,333,302,90.690002,288,14
1400000US06037603008,6037603008,2015,788,670,85.029999,646,24
1400000US06037603101,6037603101,2015,0,0,,0,0
1400000US06037603200,6037603200,2015,1529,967,63.240002,862,105
1400000US06037603301,6037603301,2015,2112,1536,72.730003,1325,211
1400000US06037603400,6037603400,2015,841,516,61.360001,446,70
1400000US06037603600,6037603600,2015,170,125,73.529999,113,12
1400000US06037603702,6037603702,2015,554,327,59.029999,239,88
1400000US06037603705,6037603705,2015,101,63,62.380001,63,0
1400000US06037603706,6037603706,2015,684,635,92.839996,556,79
1400000US06037603801,6037603801,2015,1708,1428,83.610001,1261,167
1400000US06037603802,6037603802,2015,1767,1499,84.830002,1277,222
1400000US06037603901,6037603901,2015,3392,2881,84.940002,2303,578
1400000US06037603902,6037603902,2015,902,706,78.269997,564,142
1400000US06037604001,6037604001,2015,510,400,78.43,320,80
1400000US06037604002,6037604002,2015,766,637,83.160004,523,114
1400000US06037604200,6037604200,2015,1299,1159,89.220001,1014,145
1400000US06037620001,6037620001,2015,743,72,9.6899996,61,11
1400000US06037620002,6037620002,2015,817,91,11.14,69,22
1400000US06037620101,6037620101,2015,1832,201,10.97,150,51
1400000US06037620303,6037620303,2015,654,4,.61000001,4,0
1400000US06037620305,6037620305,2015,717,5,.69999999,4,1
1400000US06037620400,6037620400,2015,1966,33,1.6799999,27,6
1400000US06037620501,6037620501,2015,579,77,13.3,49,28
1400000US06037620521,6037620521,2015,451,109,24.17,75,34
1400000US06037620602,6037620602,2015,1676,479,28.58,359,120
1400000US06037620701,6037620701,2015,451,89,19.73,67,22
1400000US06037620703,6037620703,2015,653,38,5.8200002,28,10
1400000US06037620802,6037620802,2015,2987,85,2.8499999,61,24
1400000US06037620904,6037620904,2015,416,2,.47999999,2,0
1400000US06037621005,6037621005,2015,1454,35,2.4100001,34,1
1400000US06037621201,6037621201,2015,4206,762,18.120001,582,180
1400000US06037621301,6037621301,2015,645,69,10.7,53,16
1400000US06037621400,6037621400,2015,498,64,12.85,49,15
1400000US06037650001,6037650001,2015,1133,428,37.779999,328,100
1400000US06037650004,6037650004,2015,330,193,58.48,161,32
1400000US06037650101,6037650101,2015,565,179,31.68,134,45
1400000US06037650200,6037650200,2015,2720,1194,43.900002,903,291
1400000US06037650300,6037650300,2015,588,338,57.48,261,77
1400000US06037650401,6037650401,2015,1244,379,30.469999,288,91
1400000US06037650502,6037650502,2015,1371,208,15.17,132,76
1400000US06037650603,6037650603,2015,3014,728,24.15,492,236
1400000US06037650701,6037650701,2015,585,162,27.690001,121,41
1400000US06037650702,6037650702,2015,636,58,9.1199999,44,14
1400000US06037650903,6037650903,2015,2053,681,33.169998,522,159
1400000US06037650904,6037650904,2015,667,407,61.02,318,89
1400000US06037651001,6037651001,2015,711,378,53.16,305,73
1400000US06037651002,6037651002,2015,770,300,38.959999,227,73
1400000US06037651101,6037651101,2015,892,107,12,61,46
1400000US06037651201,6037651201,2015,586,78,13.31,59,19
1400000US06037651221,6037651221,2015,733,167,22.780001,111,56
1400000US06037651222,6037651222,2015,2808,460,16.379999,323,137
1400000US06037651302,6037651302,2015,1336,163,12.2,127,36
1400000US06037651402,6037651402,2015,639,99,15.49,67,32
1400000US06037670002,6037670002,2015,1508,1034,68.57,910,124
1400000US06037670003,6037670003,2015,937,558,59.549999,417,141
1400000US06037670101,6037670101,2015,583,472,80.959999,422,50
1400000US06037670202,6037670202,2015,429,8,1.86,7,1
1400000US06037670324,6037670324,2015,594,18,3.03,17,1
1400000US06037670326,6037670326,2015,452,8,1.77,7,1
1400000US06037670328,6037670328,2015,2944,43,1.46,34,9
1400000US06037670405,6037670405,2015,966,27,2.8,15,12
1400000US06037670413,6037670413,2015,430,6,1.4,6,0
1400000US06037670416,6037670416,2015,361,28,7.7600002,24,4
1400000US06037670417,6037670417,2015,2945,96,3.26,76,20
1400000US06037670418,6037670418,2015,944,6,.63999999,4,2
1400000US06037670500,6037670500,2015,71,5,7.04,5,0
1400000US06037670604,6037670604,2015,381,12,3.1500001,9,3
1400000US06037670701,6037670701,2015,2291,1176,51.330002,974,202
1400000US06037670702,6037670702,2015,864,46,5.3200002,35,11
1400000US06037700200,6037700200,2015,1762,807,45.799999,559,248
1400000US06037700400,6037700400,2015,311,165,53.049999,119,46
1400000US06037700501,6037700501,2015,374,45,12.03,35,10
1400000US06037700600,6037700600,2015,656,48,7.3200002,35,13
1400000US06037700700,6037700700,2015,677,26,3.8399999,24,2
1400000US06037700901,6037700901,2015,521,46,8.8299999,36,10
1400000US06037700902,6037700902,2015,663,31,4.6799998,23,8
1400000US06037701000,6037701000,2015,1607,122,7.5900002,94,28
1400000US06037701304,6037701304,2015,831,106,12.76,86,20
1400000US06037701501,6037701501,2015,1027,188,18.309999,151,37
1400000US06037701601,6037701601,2015,818,47,5.75,38,9
1400000US06037701602,6037701602,2015,466,201,43.130001,155,46
1400000US06037701801,6037701801,2015,449,237,52.779999,200,37
1400000US06037701902,6037701902,2015,2886,843,29.209999,692,151
1400000US06037702002,6037702002,2015,545,163,29.91,143,20
1400000US06037702201,6037702201,2015,1553,745,47.970001,628,117
1400000US06037702300,6037702300,2015,635,188,29.610001,154,34
1400000US06037702400,6037702400,2015,525,180,34.290001,141,39
1400000US06037702600,6037702600,2015,1342,331,24.66,240,91
1400000US06037702700,6037702700,2015,4205,1447,34.41,1152,295
1400000US06037702801,6037702801,2015,571,338,59.189999,292,46
1400000US06037702803,6037702803,2015,614,404,65.800003,365,39
1400000US06037703002,6037703002,2015,625,341,54.560001,300,41
1400000US06037703100,6037703100,2015,535,381,71.209999,333,48
1400000US06037703200,6037703200,2015,288,208,72.220001,204,4
1400000US06037800101,6037800101,2015,3120,227,7.2800002,173,54
1400000US06037800103,6037800103,2015,299,12,4.0100002,11,1
1400000US06037800202,6037800202,2015,1466,123,8.3900003,98,25
1400000US06037800205,6037800205,2015,602,69,11.46,57,12
1400000US06037800206,6037800206,2015,577,30,5.1999998,26,4
1400000US06037800325,6037800325,2015,426,16,3.76,13,3
1400000US06037800334,6037800334,2015,2862,285,9.96,229,56
1400000US06037800335,6037800335,2015,9,9,100,9,0
1400000US06037800338,6037800338,2015,1977,116,5.8699999,92,24
1400000US06037800406,6037800406,2015,12,12,100,12,0
1400000US06037800411,6037800411,2015,1314,163,12.4,139,24
1400000US06037800412,6037800412,2015,218,10,4.5900002,10,0
1400000US06037800504,6037800504,2015,313,23,7.3499999,20,3
1400000US06037900102,6037900102,2015,721,670,92.93,626,44
1400000US06037900103,6037900103,2015,590,576,97.629997,544,32
1400000US06037900104,6037900104,2015,493,421,85.400002,372,49
1400000US06037900301,6037900301,2015,652,590,90.489998,538,52
1400000US06037900501,6037900501,2015,684,604,88.300003,560,44
1400000US06037900504,6037900504,2015,2389,1665,69.690002,1504,161
1400000US06037900505,6037900505,2015,863,741,85.860001,674,67
1400000US06037900508,6037900508,2015,2190,1677,76.580002,1483,194
1400000US06037900510,6037900510,2015,1417,1233,87.010002,1129,104
1400000US06037900602,6037900602,2015,948,847,89.349998,814,33
1400000US06037900606,6037900606,2015,2954,2234,75.629997,2087,147
1400000US06037900607,6037900607,2015,749,675,90.120003,638,37
1400000US06037900609,6037900609,2015,1007,844,83.809998,764,80
1400000US06037900610,6037900610,2015,642,570,88.790001,520,50
1400000US06037900701,6037900701,2015,1072,863,80.5,826,37
1400000US06037900703,6037900703,2015,1776,1473,82.940002,1322,151
1400000US06037900804,6037900804,2015,759,678,89.330002,654,24
1400000US06037900805,6037900805,2015,868,719,82.830002,656,63
1400000US06037900807,6037900807,2015,823,682,82.870003,632,50
1400000US06037900901,6037900901,2015,706,285,40.369999,222,63
1400000US06037901007,6037901007,2015,721,369,51.18,315,54
1400000US06037901009,6037901009,2015,948,675,71.199997,578,97
1400000US06037901010,6037901010,2015,636,475,74.690002,420,55
1400000US06037901011,6037901011,2015,631,430,68.150002,387,43
1400000US06037901012,6037901012,2015,773,495,64.040001,424,71
1400000US06037901013,6037901013,2015,1280,714,55.779999,566,148
1400000US06037901014,6037901014,2015,2268,1297,57.189999,1072,225
1400000US06037901101,6037901101,2015,1017,501,49.259998,434,67
1400000US06037901209,6037901209,2015,383,175,45.689999,153,22
1400000US06037901214,6037901214,2015,1004,458,45.619999,403,55
1400000US06037901215,6037901215,2015,3269,1072,32.790001,854,218
1400000US06037901217,6037901217,2015,127,38,29.92,30,8
1400000US06037901300,6037901300,2015,584,540,92.470001,509,31
1400000US06037910002,6037910002,2015,385,295,76.620003,250,45
1400000US06037910210,6037910210,2015,1020,372,36.470001,288,84
1400000US06037910212,6037910212,2015,912,166,18.200001,126,40
1400000US06037910214,6037910214,2015,3982,2344,58.860001,1926,418
1400000US06037910215,6037910215,2015,1520,1172,77.110001,1005,167
1400000US06037910217,6037910217,2015,559,282,50.450001,234,48
1400000US06037910218,6037910218,2015,635,352,55.43,330,22
1400000US06037910301,6037910301,2015,814,410,50.369999,359,51
1400000US06037910302,6037910302,2015,1635,605,37,482,123
1400000US06037910401,6037910401,2015,993,689,69.389999,575,114
1400000US06037910404,6037910404,2015,753,642,85.260002,572,70
1400000US06037910405,6037910405,2015,1481,1250,84.400002,1111,139
1400000US06037910504,6037910504,2015,1053,982,93.260002,903,79
1400000US06037910601,6037910601,2015,765,679,88.760002,620,59
1400000US06037910602,6037910602,2015,3587,2651,73.910004,2213,438
1400000US06037910605,6037910605,2015,1513,1254,82.879997,1123,131
1400000US06037910606,6037910606,2015,52,49,94.230003,44,5
1400000US06037910608,6037910608,2015,960,812,84.580002,738,74
1400000US06037910706,6037910706,2015,858,730,85.080002,613,117
1400000US06037910712,6037910712,2015,764,656,85.860001,541,115
1400000US06037910714,6037910714,2015,1582,1374,86.849998,1147,227
1400000US06037910715,6037910715,2015,791,694,87.739998,595,99
1400000US06037910716,6037910716,2015,1421,1177,82.830002,1006,171
1400000US06037910717,6037910717,2015,4702,3426,72.860001,2743,683
1400000US06037910718,6037910718,2015,1664,1382,83.050003,1138,244
1400000US06037910720,6037910720,2015,867,734,84.660004,609,125
1400000US06037910807,6037910807,2015,1059,602,56.849998,470,132
1400000US06037910814,6037910814,2015,195,52,26.67,50,2
1400000US06037910815,6037910815,2015,1285,562,43.740002,475,87
1400000US06037911001,6037911001,2015,809,649,80.220001,592,57
1400000US06037911100,6037911100,2015,2404,2003,83.32,1798,205
1400000US06037920013,6037920013,2015,651,98,15.05,72,26
1400000US06037920015,6037920015,2015,788,67,8.5,52,15
1400000US06037920017,6037920017,2015,1037,199,19.190001,151,48
1400000US06037920020,6037920020,2015,751,199,26.5,149,50
1400000US06037920029,6037920029,2015,2827,811,28.690001,642,169
1400000US06037920031,6037920031,2015,3127,1304,41.700001,1070,234
1400000US06037920034,6037920034,2015,1132,625,55.209999,522,103
1400000US06037920035,6037920035,2015,546,482,88.279999,423,59
1400000US06037920041,6037920041,2015,613,216,35.240002,157,59
1400000US06037920042,6037920042,2015,558,362,64.870003,300,62
1400000US06037920043,6037920043,2015,1444,503,34.830002,356,147
1400000US06037920044,6037920044,2015,2404,304,12.65,230,74
1400000US06037920048,6037920048,2015,2352,1233,52.419998,1009,224
1400000US06037920049,6037920049,2015,713,126,17.67,96,30
1400000US06037920102,6037920102,2015,880,395,44.889999,329,66
1400000US06037920109,6037920109,2015,757,103,13.61,72,31
1400000US06037920111,6037920111,2015,412,124,30.1,80,44
1400000US06037920112,6037920112,2015,1245,197,15.82,148,49
1400000US06037920115,6037920115,2015,1675,145,8.6599998,109,36
1400000US06037920118,6037920118,2015,2464,713,28.940001,530,183
1400000US06037920119,6037920119,2015,475,63,13.26,46,17
1400000US06037920120,6037920120,2015,603,60,9.9499998,39,21
1400000US06037920121,6037920121,2015,7638,1375,18,1085,290
1400000US06037920313,6037920313,2015,1200,782,65.169998,705,77
1400000US06037920314,6037920314,2015,535,179,33.459999,157,22
1400000US06037920322,6037920322,2015,462,187,40.48,171,16
1400000US06037920326,6037920326,2015,950,164,17.26,112,52
1400000US06037920329,6037920329,2015,1299,609,46.880001,517,92
1400000US06037920330,6037920330,2015,384,39,10.16,31,8
1400000US06037920334,6037920334,2015,614,137,22.309999,95,42
1400000US06037920338,6037920338,2015,806,57,7.0700002,46,11
1400000US06037920339,6037920339,2015,3865,358,9.2600002,256,102
1400000US06037920340,6037920340,2015,3309,939,28.379999,804,135
1400000US06037920341,6037920341,2015,608,528,86.839996,481,47
1400000US06037920342,6037920342,2015,694,601,86.599998,543,58
1400000US06037930400,6037930400,2015,163,17,10.43,14,3
1400000US06037980004,6037980004,2015,789,749,94.93,708,41
1400000US06037980013,6037980013,2015,642,270,42.060001,181,89
1400000US06037980016,6037980016,2015,257,244,94.940002,233,11
